x,y,cell,cell_x,cell_y,opt_traj,point_id,steps_taken,extra_steps
61,18,0,65.0,20.0,13,6559,43,30
69,21,0,65.0,20.0,18,7650,46,28
65,17,0,65.0,20.0,18,6202,113,95
67,18,0,65.0,20.0,19,6565,38,19
66,18,0,65.0,20.0,18,6564,138,120
61,18,0,65.0,20.0,13,6559,1001,988
67,22,0,65.0,20.0,15,8009,30,15
66,24,0,65.0,20.0,12,8730,41,29
62,21,0,65.0,20.0,11,7643,48,37
61,18,0,65.0,20.0,13,6559,114,101
70,22,1,75.0,20.0,18,8012,53,35
71,19,1,75.0,20.0,22,6930,52,30
74,24,1,75.0,20.0,20,8738,46,26
77,16,1,75.0,20.0,31,5853,127,96
78,21,1,75.0,20.0,27,7659,166,139
71,24,1,75.0,20.0,17,8735,40,23
70,19,1,75.0,20.0,21,6929,36,15
72,20,1,75.0,20.0,22,7292,54,32
77,16,1,75.0,20.0,31,5853,124,93
78,24,1,75.0,20.0,24,8742,51,27
84,23,2,85.0,20.0,31,8387,47,16
82,23,2,85.0,20.0,29,8385,66,37
88,19,2,85.0,20.0,39,6947,97,58
87,24,2,85.0,20.0,33,8751,85,52
80,21,2,85.0,20.0,29,7661,44,15
81,24,2,85.0,20.0,27,8745,45,18
83,21,2,85.0,20.0,32,7664,69,37
86,22,2,85.0,20.0,34,8028,67,33
84,19,2,85.0,20.0,35,6943,72,37
84,23,2,85.0,20.0,31,8387,61,30
91,20,3,95.0,20.0,41,7311,79,38
96,19,3,95.0,20.0,47,6955,66,19
94,15,3,95.0,20.0,49,5509,131,82
98,23,3,95.0,20.0,45,8401,69,24
95,15,3,95.0,20.0,50,5510,131,81
98,22,3,95.0,20.0,46,8040,63,17
91,21,3,95.0,20.0,40,7672,74,34
93,18,3,95.0,20.0,45,6591,81,36
96,23,3,95.0,20.0,43,8399,89,46
99,16,3,95.0,20.0,53,5875,139,86
103,15,4,105.0,20.0,58,5518,145,87
103,18,4,105.0,20.0,55,6601,155,100
103,21,4,105.0,20.0,52,7684,101,49
105,16,4,105.0,20.0,59,5881,148,89
106,17,4,105.0,20.0,59,6243,153,94
101,18,4,105.0,20.0,53,6599,90,37
100,18,4,105.0,20.0,52,6598,78,26
101,21,4,105.0,20.0,50,7682,113,63
107,18,4,105.0,20.0,59,6605,101,42
105,21,4,105.0,20.0,54,7686,82,28
119,23,5,115.0,20.0,66,8422,115,49
112,20,5,115.0,20.0,62,7332,107,45
116,22,5,115.0,20.0,64,8058,90,26
113,18,5,115.0,20.0,65,6611,156,91
119,24,5,115.0,20.0,65,8783,140,75
112,23,5,115.0,20.0,59,8415,112,53
113,17,5,115.0,20.0,66,6250,166,100
112,17,5,115.0,20.0,65,6249,160,95
114,20,5,115.0,20.0,64,7334,93,29
118,17,5,115.0,20.0,71,6255,89,18
123,23,6,125.0,20.0,70,8426,96,26
124,19,6,125.0,20.0,75,6983,99,24
128,20,6,125.0,20.0,78,7348,136,58
122,16,6,125.0,20.0,76,5898,172,96
122,23,6,125.0,20.0,69,8425,128,59
125,22,6,125.0,20.0,73,8067,107,34
123,19,6,125.0,20.0,74,6982,169,95
126,18,6,125.0,20.0,78,6624,101,23
121,20,6,125.0,20.0,71,7341,102,31
126,23,6,125.0,20.0,73,8429,102,29
138,15,7,135.0,20.0,93,5553,178,85
130,24,7,135.0,20.0,76,8794,200,124
134,24,7,135.0,20.0,80,8798,109,29
130,23,7,135.0,20.0,77,8433,108,31
130,19,7,135.0,20.0,81,6989,113,32
134,17,7,135.0,20.0,87,6271,184,97
130,15,7,135.0,20.0,85,5545,168,83
137,17,7,135.0,20.0,90,6274,184,94
137,18,7,135.0,20.0,89,6635,117,28
130,18,7,135.0,20.0,82,6628,107,25
145,17,8,145.0,20.0,98,6282,133,35
146,24,8,145.0,20.0,92,8810,113,21
142,16,8,145.0,20.0,96,5918,198,102
145,22,8,145.0,20.0,93,8087,145,52
146,18,8,145.0,20.0,98,6644,135,37
148,18,8,145.0,20.0,100,6646,147,47
141,22,8,145.0,20.0,89,8083,123,34
145,20,8,145.0,20.0,95,7365,121,26
145,18,8,145.0,20.0,97,6643,119,22
143,15,8,145.0,20.0,98,5558,135,37
156,21,9,155.0,20.0,105,7737,206,101
151,16,9,155.0,20.0,105,5927,128,23
153,17,9,155.0,20.0,106,6290,202,96
154,16,9,155.0,20.0,108,5930,151,43
153,23,9,155.0,20.0,100,8456,136,36
156,21,9,155.0,20.0,105,7737,145,40
159,20,9,155.0,20.0,109,7379,208,99
153,21,9,155.0,20.0,102,7734,155,53
150,17,9,155.0,20.0,103,6287,213,110
156,24,9,155.0,20.0,102,8820,209,107
160,18,10,165.0,20.0,112,6658,150,38
165,24,10,165.0,20.0,111,8829,162,51
167,23,10,165.0,20.0,114,8470,162,48
165,16,10,165.0,20.0,119,5941,204,85
166,21,10,165.0,20.0,115,7747,149,34
161,18,10,165.0,20.0,113,6659,218,105
160,21,10,165.0,20.0,109,7741,149,40
163,20,10,165.0,20.0,113,7383,145,32
164,21,10,165.0,20.0,113,7745,151,38
166,16,10,165.0,20.0,120,5942,218,98
177,17,11,175.0,20.0,130,6314,231,101
175,17,11,175.0,20.0,128,6312,239,111
174,20,11,175.0,20.0,124,7394,169,45
170,21,11,175.0,20.0,119,7751,173,54
174,15,11,175.0,20.0,129,5589,218,89
177,23,11,175.0,20.0,124,8480,271,147
177,20,11,175.0,20.0,127,7397,198,71
176,20,11,175.0,20.0,126,7396,166,40
173,16,11,175.0,20.0,127,5949,212,85
178,21,11,175.0,20.0,127,7759,154,27
183,19,12,185.0,20.0,134,7042,1001,867
181,21,12,185.0,20.0,130,7762,230,100
186,19,12,185.0,20.0,137,7045,1001,864
182,24,12,185.0,20.0,128,8846,1001,873
189,21,12,185.0,20.0,138,7770,1001,863
187,20,12,185.0,20.0,137,7407,1001,864
189,20,12,185.0,20.0,139,7409,250,111
186,16,12,185.0,20.0,140,5962,230,90
188,19,12,185.0,20.0,139,7047,254,115
187,22,12,185.0,20.0,135,8129,1001,866
197,24,13,195.0,20.0,143,8861,253,110
195,16,13,195.0,20.0,149,5971,243,94
192,15,13,195.0,20.0,147,5607,252,105
191,18,13,195.0,20.0,143,6689,245,102
192,19,13,195.0,20.0,143,7051,1001,858
191,23,13,195.0,20.0,138,8494,274,136
190,17,13,195.0,20.0,143,6327,242,99
199,16,13,195.0,20.0,153,5975,250,97
193,15,13,195.0,20.0,148,5608,234,86
196,21,13,195.0,20.0,145,7777,245,100
208,19,14,205.0,20.0,159,7067,266,107
200,19,14,205.0,20.0,151,7059,263,112
202,16,14,205.0,20.0,156,5978,246,90
206,15,14,205.0,20.0,161,5621,254,93
204,22,14,205.0,20.0,152,8146,295,143
209,17,14,205.0,20.0,162,6346,274,112
202,20,14,205.0,20.0,152,7422,268,116
203,17,14,205.0,20.0,156,6340,245,89
209,20,14,205.0,20.0,159,7429,272,113
203,22,14,205.0,20.0,151,8145,270,119
214,24,15,215.0,20.0,160,8878,270,110
212,19,15,215.0,20.0,163,7071,262,99
219,19,15,215.0,20.0,170,7078,307,137
214,24,15,215.0,20.0,160,8878,272,112
215,21,15,215.0,20.0,164,7796,280,116
213,19,15,215.0,20.0,164,7072,270,106
218,20,15,215.0,20.0,168,7438,287,119
213,16,15,215.0,20.0,167,5989,695,528
213,23,15,215.0,20.0,160,8516,277,117
214,17,15,215.0,20.0,167,6351,293,126
223,21,16,225.0,20.0,172,7804,291,119
220,15,16,225.0,20.0,175,5635,265,90
220,20,16,225.0,20.0,170,7440,270,100
226,20,16,225.0,20.0,176,7446,303,127
220,18,16,225.0,20.0,172,6718,294,122
225,17,16,225.0,20.0,178,6362,706,528
224,19,16,225.0,20.0,175,7083,299,124
225,22,16,225.0,20.0,173,8167,300,127
221,18,16,225.0,20.0,173,6719,279,106
229,17,16,225.0,20.0,182,6366,1001,819
239,18,17,235.0,20.0,191,6737,404,213
230,20,17,235.0,20.0,180,7450,1001,821
234,15,17,235.0,20.0,189,5649,411,222
231,15,17,235.0,20.0,186,5646,1001,815
236,17,17,235.0,20.0,189,6373,423,234
230,15,17,235.0,20.0,185,5645,405,220
231,23,17,235.0,20.0,178,8534,303,125
232,20,17,235.0,20.0,182,7452,1001,819
239,18,17,235.0,20.0,191,6737,423,232
231,19,17,235.0,20.0,182,7090,1001,819
242,22,18,245.0,20.0,190,8184,323,133
241,18,18,245.0,20.0,193,6739,434,241
246,21,18,245.0,20.0,195,7827,332,137
249,22,18,245.0,20.0,197,8191,318,121
245,24,18,245.0,20.0,191,8909,325,134
245,18,18,245.0,20.0,197,6743,408,211
245,18,18,245.0,20.0,197,6743,413,216
241,18,18,245.0,20.0,193,6739,418,225
241,24,18,245.0,20.0,187,8905,369,182
246,21,18,245.0,20.0,195,7827,416,221
250,23,19,255.0,20.0,197,8553,309,112
253,15,19,255.0,20.0,208,5668,412,204
253,17,19,255.0,20.0,206,6390,344,138
254,18,19,255.0,20.0,206,6752,386,180
252,22,19,255.0,20.0,200,8194,321,121
259,16,19,255.0,20.0,213,6035,435,222
252,16,19,255.0,20.0,206,6028,408,202
250,16,19,255.0,20.0,204,6026,443,239
256,17,19,255.0,20.0,209,6393,411,202
256,18,19,255.0,20.0,208,6754,399,191
267,19,20,265.0,20.0,218,7126,387,169
262,16,20,265.0,20.0,216,6038,419,203
265,16,20,265.0,20.0,219,6041,377,158
265,16,20,265.0,20.0,219,6041,383,164
262,19,20,265.0,20.0,213,7121,349,136
264,15,20,265.0,20.0,219,5679,394,175
265,24,20,265.0,20.0,211,8929,1001,790
267,17,20,265.0,20.0,220,6404,392,172
269,15,20,265.0,20.0,224,5684,421,197
266,23,20,265.0,20.0,213,8569,324,111
270,22,21,275.0,20.0,218,8212,341,123
279,24,21,275.0,20.0,225,8943,343,118
272,23,21,275.0,20.0,219,8575,352,133
274,16,21,275.0,20.0,228,6050,424,196
272,15,21,275.0,20.0,227,5687,452,225
275,15,21,275.0,20.0,230,5690,455,225
274,15,21,275.0,20.0,229,5689,456,227
279,15,21,275.0,20.0,234,5694,456,222
270,16,21,275.0,20.0,224,6046,445,221
276,20,21,275.0,20.0,226,7496,346,120
283,21,22,285.0,20.0,232,7864,354,122
280,21,22,285.0,20.0,229,7861,378,149
281,16,22,285.0,20.0,235,6057,412,177
288,22,22,285.0,20.0,236,8230,359,123
282,23,22,285.0,20.0,229,8585,396,167
285,22,22,285.0,20.0,233,8227,367,134
289,17,22,285.0,20.0,242,6426,409,167
283,18,22,285.0,20.0,235,6781,416,181
284,20,22,285.0,20.0,234,7504,403,169
285,16,22,285.0,20.0,239,6061,397,158
293,22,23,295.0,20.0,241,8235,1001,760
299,15,23,295.0,20.0,254,5714,556,302
290,21,23,295.0,20.0,239,7871,409,170
290,24,23,295.0,20.0,236,8954,389,153
298,19,23,295.0,20.0,249,7157,426,177
296,23,23,295.0,20.0,243,8599,1001,758
298,17,23,295.0,20.0,251,6435,453,202
297,24,23,295.0,20.0,243,8961,1001,758
292,17,23,295.0,20.0,245,6429,427,182
292,15,23,295.0,20.0,247,5707,471,224
304,20,24,305.0,20.0,254,7524,443,189
304,22,24,305.0,20.0,252,8246,412,160
305,15,24,305.0,20.0,260,5720,562,302
306,16,24,305.0,20.0,260,6082,497,237
303,22,24,305.0,20.0,251,8245,1001,750
300,18,24,305.0,20.0,252,6798,456,204
301,23,24,305.0,20.0,248,8604,429,181
306,24,24,305.0,20.0,252,8970,424,172
303,24,24,305.0,20.0,249,8967,1001,752
302,23,24,305.0,20.0,249,8605,409,160
313,23,25,312.5,20.0,260,8616,459,199
312,17,25,312.5,20.0,265,6449,454,189
310,18,25,312.5,20.0,262,6808,435,173
311,18,25,312.5,20.0,263,6809,440,177
311,18,25,312.5,20.0,263,6809,442,179
310,21,25,312.5,20.0,259,7891,441,182
313,16,25,312.5,20.0,267,6089,493,226
311,21,25,312.5,20.0,260,7892,443,183
310,19,25,312.5,20.0,261,7169,437,176
311,15,25,312.5,20.0,266,5726,490,224
61,25,26,65.0,30.0,6,9086,21,15
66,26,26,65.0,30.0,10,9452,36,26
63,25,26,65.0,30.0,8,9088,23,15
69,31,26,65.0,30.0,10,11260,23,13
68,29,26,65.0,30.0,9,10537,15,6
63,29,26,65.0,30.0,4,10532,28,24
64,25,26,65.0,30.0,9,9089,26,17
64,26,26,65.0,30.0,8,9450,62,54
63,34,26,65.0,30.0,7,12337,47,40
66,28,26,65.0,30.0,8,10174,44,36
79,30,27,75.0,30.0,19,10909,23,4
72,26,27,75.0,30.0,16,9458,72,56
76,25,27,75.0,30.0,21,9101,53,32
76,33,27,75.0,30.0,19,11989,22,3
78,33,27,75.0,30.0,21,11991,63,42
70,27,27,75.0,30.0,13,9817,33,20
77,31,27,75.0,30.0,18,11268,30,12
76,34,27,75.0,30.0,20,12350,35,15
74,27,27,75.0,30.0,17,9821,43,26
72,26,27,75.0,30.0,16,9458,42,26
84,25,28,85.0,30.0,29,9109,63,34
89,26,28,85.0,30.0,33,9475,80,47
85,32,28,85.0,30.0,27,11637,42,15
82,27,28,85.0,30.0,25,9829,53,28
89,31,28,85.0,30.0,30,11280,57,27
81,32,28,85.0,30.0,23,11633,30,7
85,32,28,85.0,30.0,27,11637,79,52
84,34,28,85.0,30.0,28,12358,49,21
83,29,28,85.0,30.0,24,10552,46,22
85,33,28,85.0,30.0,28,11998,67,39
99,26,29,95.0,30.0,43,9485,108,65
97,29,29,95.0,30.0,38,10566,72,34
93,34,29,95.0,30.0,37,12367,85,48
92,31,29,95.0,30.0,33,11283,77,44
98,31,29,95.0,30.0,39,11289,117,78
90,26,29,95.0,30.0,34,9476,90,56
97,29,29,95.0,30.0,38,10566,80,42
97,27,29,95.0,30.0,40,9844,87,47
99,29,29,95.0,30.0,40,10568,68,28
92,28,29,95.0,30.0,34,10200,74,40
103,31,30,105.0,30.0,44,11294,73,29
106,27,30,105.0,30.0,49,9853,86,37
103,31,30,105.0,30.0,44,11294,71,27
101,34,30,105.0,30.0,45,12375,67,22
100,25,30,105.0,30.0,45,9125,83,38
104,25,30,105.0,30.0,49,9129,69,20
103,31,30,105.0,30.0,44,11294,59,15
102,33,30,105.0,30.0,45,12015,116,71
104,26,30,105.0,30.0,48,9490,65,17
105,34,30,105.0,30.0,49,12379,64,15
119,32,31,115.0,30.0,61,11671,118,57
118,30,31,115.0,30.0,58,10948,82,24
119,26,31,115.0,30.0,63,9505,113,50
111,25,31,115.0,30.0,56,9136,78,22
115,29,31,115.0,30.0,56,10584,83,27
111,29,31,115.0,30.0,52,10580,92,40
116,26,31,115.0,30.0,60,9502,82,22
119,25,31,115.0,30.0,64,9144,307,243
116,26,31,115.0,30.0,60,9502,108,48
110,31,31,115.0,30.0,51,11301,116,65
123,33,32,125.0,30.0,66,12036,93,27
124,32,32,125.0,30.0,66,11676,145,79
126,34,32,125.0,30.0,70,12400,85,15
127,31,32,125.0,30.0,68,11318,101,33
125,25,32,125.0,30.0,70,9150,89,19
128,33,32,125.0,30.0,71,12041,89,18
122,28,32,125.0,30.0,64,10230,120,56
121,31,32,125.0,30.0,62,11312,97,35
121,26,32,125.0,30.0,65,9507,106,41
120,31,32,125.0,30.0,61,11311,79,18
139,33,33,135.0,30.0,82,12052,174,92
130,32,33,135.0,30.0,72,11682,93,21
130,34,33,135.0,30.0,74,12404,99,25
131,27,33,135.0,30.0,74,9878,117,43
138,26,33,135.0,30.0,82,9524,105,23
130,25,33,135.0,30.0,75,9155,112,37
133,30,33,135.0,30.0,73,10963,120,47
130,34,33,135.0,30.0,74,12404,108,34
139,27,33,135.0,30.0,82,9886,102,20
137,26,33,135.0,30.0,81,9523,198,117
142,27,34,145.0,30.0,85,9889,150,65
141,31,34,145.0,30.0,82,11332,837,755
145,29,34,145.0,30.0,86,10614,148,62
142,32,34,145.0,30.0,84,11694,102,18
145,25,34,145.0,30.0,90,9170,122,32
140,34,34,145.0,30.0,84,12414,105,21
148,34,34,145.0,30.0,92,12422,100,8
142,26,34,145.0,30.0,86,9528,119,33
146,33,34,145.0,30.0,89,12059,168,79
145,31,34,145.0,30.0,86,11336,835,749
156,26,35,155.0,30.0,100,9542,200,100
153,34,35,155.0,30.0,97,12427,112,15
153,29,35,155.0,30.0,94,10622,119,25
152,25,35,155.0,30.0,97,9177,136,39
151,29,35,155.0,30.0,92,10620,146,54
158,27,35,155.0,30.0,101,9905,149,48
153,27,35,155.0,30.0,96,9900,144,48
159,29,35,155.0,30.0,100,10628,834,734
155,27,35,155.0,30.0,98,9902,128,30
152,32,35,155.0,30.0,94,11704,127,33
163,28,36,165.0,30.0,105,10271,218,113
168,30,36,165.0,30.0,108,10998,847,739
167,28,36,165.0,30.0,109,10275,922,813
161,28,36,165.0,30.0,103,10269,311,208
164,34,36,165.0,30.0,108,12438,145,37
162,30,36,165.0,30.0,102,10992,188,86
164,30,36,165.0,30.0,104,10994,149,45
167,31,36,165.0,30.0,108,11358,847,739
165,33,36,165.0,30.0,108,12078,186,78
160,27,36,165.0,30.0,103,9907,141,38
177,34,37,175.0,30.0,121,12451,759,638
170,25,37,175.0,30.0,115,9195,235,120
173,27,37,175.0,30.0,116,9920,136,20
174,31,37,175.0,30.0,115,11365,847,732
179,27,37,175.0,30.0,122,9926,173,51
176,26,37,175.0,30.0,120,9562,176,56
174,31,37,175.0,30.0,115,11365,178,63
171,29,37,175.0,30.0,112,10640,357,245
173,25,37,175.0,30.0,118,9198,174,56
175,26,37,175.0,30.0,119,9561,148,29
186,33,38,185.0,30.0,129,12099,1001,872
183,27,38,185.0,30.0,126,9930,1001,875
186,33,38,185.0,30.0,129,12099,271,142
183,28,38,185.0,30.0,125,10291,279,154
183,27,38,185.0,30.0,126,9930,279,153
182,31,38,185.0,30.0,123,11373,1001,878
189,29,38,185.0,30.0,130,10658,285,155
185,31,38,185.0,30.0,126,11376,266,140
188,28,38,185.0,30.0,130,10296,1001,871
188,28,38,185.0,30.0,130,10296,259,129
199,30,39,195.0,30.0,139,11029,272,133
190,34,39,195.0,30.0,134,12464,1001,867
199,28,39,195.0,30.0,141,10307,258,117
192,31,39,195.0,30.0,133,11383,263,130
197,29,39,195.0,30.0,138,10666,273,135
198,30,39,195.0,30.0,138,11028,275,137
192,27,39,195.0,30.0,135,9939,283,148
198,30,39,195.0,30.0,138,11028,309,171
195,25,39,195.0,30.0,140,9220,299,159
198,30,39,195.0,30.0,138,11028,277,139
209,27,40,205.0,30.0,152,9956,281,129
207,34,40,205.0,30.0,151,12481,286,135
207,27,40,205.0,30.0,150,9954,301,151
206,26,40,205.0,30.0,150,9592,299,149
206,30,40,205.0,30.0,146,11036,768,622
207,30,40,205.0,30.0,147,11037,292,145
205,34,40,205.0,30.0,149,12479,281,132
208,28,40,205.0,30.0,150,10316,283,133
205,27,40,205.0,30.0,148,9952,273,125
205,29,40,205.0,30.0,146,10674,278,132
212,33,41,215.0,30.0,155,12125,304,149
218,33,41,215.0,30.0,161,12131,311,150
210,31,41,215.0,30.0,151,11401,281,130
214,25,41,215.0,30.0,159,9239,273,114
217,32,41,215.0,30.0,159,11769,286,127
217,26,41,215.0,30.0,161,9603,297,136
210,31,41,215.0,30.0,151,11401,283,132
213,34,41,215.0,30.0,157,12487,287,130
214,29,41,215.0,30.0,155,10683,288,133
213,25,41,215.0,30.0,158,9238,283,125
221,27,42,225.0,30.0,164,9968,305,141
226,29,42,225.0,30.0,167,10695,295,128
220,27,42,225.0,30.0,163,9967,301,138
228,34,42,225.0,30.0,172,12502,307,135
226,32,42,225.0,30.0,168,11778,305,137
224,27,42,225.0,30.0,167,9971,292,125
221,31,42,225.0,30.0,162,11412,354,192
224,25,42,225.0,30.0,169,9249,289,120
225,29,42,225.0,30.0,166,10694,289,123
224,34,42,225.0,30.0,168,12498,307,139
234,32,43,235.0,30.0,176,11786,334,158
234,29,43,235.0,30.0,175,10703,325,150
230,30,43,235.0,30.0,170,11060,368,198
233,26,43,235.0,30.0,177,9619,293,116
238,30,43,235.0,30.0,178,11068,354,176
238,29,43,235.0,30.0,179,10707,302,123
235,33,43,235.0,30.0,178,12148,325,147
234,26,43,235.0,30.0,178,9620,1001,823
234,33,43,235.0,30.0,177,12147,463,286
237,28,43,235.0,30.0,179,10345,303,124
242,30,44,245.0,30.0,182,11072,324,142
247,33,44,245.0,30.0,190,12160,396,206
242,30,44,245.0,30.0,182,11072,322,140
242,34,44,245.0,30.0,186,12516,393,207
243,32,44,245.0,30.0,185,11795,527,342
245,32,44,245.0,30.0,187,11797,343,156
249,26,44,245.0,30.0,193,9635,322,129
244,30,44,245.0,30.0,184,11074,325,141
244,27,44,245.0,30.0,187,9991,330,143
240,31,44,245.0,30.0,181,11431,326,145
252,34,45,255.0,30.0,196,12526,351,155
258,33,45,255.0,30.0,201,12171,405,204
256,33,45,255.0,30.0,199,12169,360,161
252,32,45,255.0,30.0,194,11804,332,138
255,33,45,255.0,30.0,198,12168,353,155
256,26,45,255.0,30.0,200,9642,330,130
251,32,45,255.0,30.0,193,11803,465,272
256,27,45,255.0,30.0,199,10003,324,125
253,26,45,255.0,30.0,197,9639,320,123
253,26,45,255.0,30.0,197,9639,342,145
268,31,46,265.0,30.0,209,11459,371,162
265,26,46,265.0,30.0,209,9651,361,152
267,28,46,265.0,30.0,209,10375,369,160
266,30,46,265.0,30.0,206,11096,379,173
261,28,46,265.0,30.0,203,10369,326,123
265,33,46,265.0,30.0,208,12178,370,162
265,30,46,265.0,30.0,205,11095,362,157
261,32,46,265.0,30.0,203,11813,351,148
267,30,46,265.0,30.0,207,11097,379,172
267,27,46,265.0,30.0,210,10014,346,136
274,26,47,275.0,30.0,218,9660,341,123
273,30,47,275.0,30.0,213,11103,384,171
274,29,47,275.0,30.0,215,10743,373,158
275,33,47,275.0,30.0,218,12188,364,146
278,27,47,275.0,30.0,221,10025,398,177
276,27,47,275.0,30.0,219,10023,343,124
279,33,47,275.0,30.0,222,12192,397,175
278,33,47,275.0,30.0,221,12191,382,161
279,28,47,275.0,30.0,221,10387,360,139
273,33,47,275.0,30.0,216,12186,368,152
284,30,48,285.0,30.0,224,11114,422,198
281,28,48,285.0,30.0,223,10389,401,178
282,29,48,285.0,30.0,223,10751,379,156
289,31,48,285.0,30.0,230,11480,398,168
284,25,48,285.0,30.0,229,9309,385,156
287,30,48,285.0,30.0,227,11117,360,133
289,34,48,285.0,30.0,233,12563,391,158
282,30,48,285.0,30.0,222,11112,375,153
289,30,48,285.0,30.0,229,11119,407,178
281,33,48,285.0,30.0,224,12194,368,144
291,29,49,295.0,30.0,232,10760,415,183
292,30,49,295.0,30.0,232,11122,397,165
297,29,49,295.0,30.0,238,10766,383,145
295,33,49,295.0,30.0,238,12208,415,177
292,32,49,295.0,30.0,234,11844,405,171
293,34,49,295.0,30.0,237,12567,413,176
297,25,49,295.0,30.0,242,9322,377,135
291,34,49,295.0,30.0,235,12565,395,160
295,29,49,295.0,30.0,236,10764,375,139
294,31,49,295.0,30.0,235,11485,412,177
306,31,50,305.0,30.0,247,11497,409,162
304,32,50,305.0,30.0,246,11856,426,180
308,26,50,305.0,30.0,252,9694,1001,749
303,31,50,305.0,30.0,244,11494,522,278
300,34,50,305.0,30.0,244,12574,405,161
300,25,50,305.0,30.0,245,9325,1001,756
306,27,50,305.0,30.0,249,10053,408,159
301,32,50,305.0,30.0,243,11853,517,274
306,32,50,305.0,30.0,248,11858,1001,753
303,28,50,305.0,30.0,245,10411,433,188
311,32,51,312.5,30.0,253,11863,527,274
311,34,51,312.5,30.0,255,12585,546,291
313,33,51,312.5,30.0,256,12226,420,164
312,30,51,312.5,30.0,252,11142,427,175
310,25,51,312.5,30.0,255,9335,417,162
313,25,51,312.5,30.0,258,9338,429,171
310,26,51,312.5,30.0,254,9696,1001,747
313,25,51,312.5,30.0,258,9338,452,194
313,33,51,312.5,30.0,256,12226,570,314
310,34,51,312.5,30.0,254,12584,532,278
69,39,52,65.0,40.0,18,14148,75,57
61,36,52,65.0,40.0,7,13057,14,7
67,36,52,65.0,40.0,13,13063,22,9
69,35,52,65.0,40.0,14,12704,24,10
66,37,52,65.0,40.0,13,13423,27,14
61,35,52,65.0,40.0,6,12696,9,3
64,35,52,65.0,40.0,9,12699,13,4
68,39,52,65.0,40.0,17,14147,91,74
63,41,52,65.0,40.0,14,14864,55,41
61,39,52,65.0,40.0,10,14140,88,78
74,38,53,75.0,40.0,22,13792,25,3
75,35,53,75.0,40.0,20,12710,51,31
70,38,53,75.0,40.0,18,13788,181,163
70,38,53,75.0,40.0,18,13788,88,70
76,39,53,75.0,40.0,25,14155,73,48
70,38,53,75.0,40.0,18,13788,24,6
76,41,53,75.0,40.0,27,14877,84,57
76,36,53,75.0,40.0,22,13072,35,13
76,37,53,75.0,40.0,23,13433,81,58
79,44,53,75.0,40.0,33,15963,78,45
80,38,54,85.0,40.0,28,13798,31,3
88,43,54,85.0,40.0,41,15611,84,43
87,44,54,85.0,40.0,41,15971,84,43
83,39,54,85.0,40.0,32,14162,81,49
89,43,54,85.0,40.0,42,15612,103,61
87,39,54,85.0,40.0,36,14166,40,4
80,38,54,85.0,40.0,28,13798,31,3
85,41,54,85.0,40.0,36,14886,79,43
84,44,54,85.0,40.0,38,15968,87,49
89,36,54,85.0,40.0,35,13085,40,5
91,37,55,95.0,40.0,38,13448,51,13
96,40,55,95.0,40.0,46,14536,97,51
94,40,55,95.0,40.0,44,14534,104,60
90,41,55,95.0,40.0,41,14891,89,48
90,42,55,95.0,40.0,42,15252,108,66
96,35,55,95.0,40.0,41,12731,67,26
90,44,55,95.0,40.0,44,15974,88,44
92,40,55,95.0,40.0,42,14532,106,64
99,38,55,95.0,40.0,47,13817,107,60
94,41,55,95.0,40.0,45,14895,96,51
107,35,56,105.0,40.0,52,12742,77,25
107,39,56,105.0,40.0,56,14186,104,48
104,39,56,105.0,40.0,53,14183,75,22
106,39,56,105.0,40.0,55,14185,113,58
100,38,56,105.0,40.0,48,13818,69,21
105,44,56,105.0,40.0,59,15989,105,46
106,38,56,105.0,40.0,54,13824,109,55
101,36,56,105.0,40.0,47,13097,65,18
102,37,56,105.0,40.0,49,13459,61,12
108,41,56,105.0,40.0,59,14909,114,55
119,42,57,115.0,40.0,71,15281,135,64
115,42,57,115.0,40.0,67,15277,138,71
116,35,57,115.0,40.0,61,12751,126,65
116,41,57,115.0,40.0,67,14917,97,30
110,41,57,115.0,40.0,61,14911,121,60
113,44,57,115.0,40.0,67,15997,128,61
110,35,57,115.0,40.0,55,12745,90,35
119,40,57,115.0,40.0,69,14559,131,62
110,43,57,115.0,40.0,63,15633,115,52
115,38,57,115.0,40.0,63,13833,78,15
124,35,58,125.0,40.0,69,12759,114,45
125,41,58,125.0,40.0,76,14926,128,52
127,38,58,125.0,40.0,75,13845,101,26
120,36,58,125.0,40.0,66,13116,89,23
120,39,58,125.0,40.0,69,14199,179,110
120,40,58,125.0,40.0,70,14560,144,74
129,36,58,125.0,40.0,75,13125,82,7
120,42,58,125.0,40.0,72,15282,124,52
120,41,58,125.0,40.0,71,14921,124,53
121,42,58,125.0,40.0,73,15283,129,56
138,44,59,135.0,40.0,92,16022,139,47
138,44,59,135.0,40.0,92,16022,143,51
131,42,59,135.0,40.0,83,15293,130,47
136,35,59,135.0,40.0,81,12771,83,2
132,38,59,135.0,40.0,80,13850,166,86
137,39,59,135.0,40.0,86,14216,161,75
134,41,59,135.0,40.0,85,14935,140,55
132,35,59,135.0,40.0,77,12767,110,33
130,37,59,135.0,40.0,77,13487,171,94
136,42,59,135.0,40.0,88,15298,136,48
147,35,60,145.0,40.0,92,12782,115,23
146,36,60,145.0,40.0,92,13142,116,24
144,42,60,145.0,40.0,96,15306,149,53
141,40,60,145.0,40.0,91,14581,186,95
144,41,60,145.0,40.0,95,14945,836,741
142,44,60,145.0,40.0,96,16026,177,81
145,43,60,145.0,40.0,98,15668,149,51
142,39,60,145.0,40.0,91,14221,94,3
149,43,60,145.0,40.0,102,15672,154,52
149,35,60,145.0,40.0,94,12784,133,39
155,36,61,155.0,40.0,101,13151,139,38
155,42,61,155.0,40.0,107,15317,169,62
152,43,61,155.0,40.0,105,15675,167,62
158,35,61,155.0,40.0,103,12793,119,16
151,42,61,155.0,40.0,103,15313,164,61
159,42,61,155.0,40.0,111,15321,195,84
153,40,61,155.0,40.0,103,14593,172,69
158,41,61,155.0,40.0,109,14959,161,52
155,40,61,155.0,40.0,105,14595,179,74
150,36,61,155.0,40.0,96,13146,844,748
168,36,62,165.0,40.0,114,13164,132,18
165,37,62,165.0,40.0,112,13522,206,94
164,36,62,165.0,40.0,110,13160,119,9
164,44,62,165.0,40.0,118,16048,857,739
160,37,62,165.0,40.0,107,13517,173,66
169,36,62,165.0,40.0,115,13165,120,5
165,40,62,165.0,40.0,115,14605,168,53
163,35,62,165.0,40.0,108,12798,145,37
160,40,62,165.0,40.0,110,14600,168,58
169,35,62,165.0,40.0,114,12804,138,24
177,40,63,175.0,40.0,127,14617,155,28
175,35,63,175.0,40.0,120,12810,198,78
178,38,63,175.0,40.0,126,13896,208,82
175,35,63,175.0,40.0,120,12810,761,641
174,35,63,175.0,40.0,119,12809,213,94
176,38,63,175.0,40.0,124,13894,151,27
172,37,63,175.0,40.0,119,13529,776,657
178,44,63,175.0,40.0,132,16062,194,62
175,37,63,175.0,40.0,122,13532,785,663
172,41,63,175.0,40.0,123,14973,794,671
183,41,64,185.0,40.0,134,14984,1001,867
181,44,64,185.0,40.0,135,16065,234,99
187,39,64,185.0,40.0,136,14266,262,126
185,38,64,185.0,40.0,133,13903,274,141
180,41,64,185.0,40.0,131,14981,198,67
182,42,64,185.0,40.0,134,15344,1001,867
189,35,64,185.0,40.0,134,12824,1001,867
182,40,64,185.0,40.0,132,14622,1001,869
186,38,64,185.0,40.0,134,13904,1001,867
189,43,64,185.0,40.0,142,15712,1001,859
191,41,65,195.0,40.0,142,14992,1001,859
190,42,65,195.0,40.0,142,15352,277,135
190,39,65,195.0,40.0,139,14269,1001,862
192,44,65,195.0,40.0,146,16076,290,144
190,40,65,195.0,40.0,140,14630,1001,861
190,37,65,195.0,40.0,137,13547,269,132
194,42,65,195.0,40.0,146,15356,285,139
199,42,65,195.0,40.0,151,15361,295,144
196,42,65,195.0,40.0,148,15358,291,143
190,44,65,195.0,40.0,144,16074,1001,857
203,43,66,205.0,40.0,156,15726,293,137
200,35,66,205.0,40.0,145,12835,292,147
201,37,66,205.0,40.0,148,13558,282,134
207,44,66,205.0,40.0,161,16091,290,129
202,43,66,205.0,40.0,155,15725,284,129
208,44,66,205.0,40.0,162,16092,292,130
206,44,66,205.0,40.0,160,16090,293,133
200,43,66,205.0,40.0,153,15723,288,135
207,38,66,205.0,40.0,155,13925,297,142
208,42,66,205.0,40.0,160,15370,287,127
218,41,67,215.0,40.0,169,15019,298,129
214,42,67,215.0,40.0,166,15376,333,167
216,36,67,215.0,40.0,162,13212,314,152
218,42,67,215.0,40.0,170,15380,328,158
210,37,67,215.0,40.0,157,13567,294,137
217,37,67,215.0,40.0,164,13574,318,154
216,41,67,215.0,40.0,167,15017,339,172
213,37,67,215.0,40.0,160,13570,296,136
210,41,67,215.0,40.0,161,15011,294,133
218,44,67,215.0,40.0,172,16102,301,129
220,37,68,225.0,40.0,167,13577,316,149
224,38,68,225.0,40.0,172,13942,302,130
220,44,68,225.0,40.0,174,16104,307,133
226,41,68,225.0,40.0,177,15027,310,133
227,37,68,225.0,40.0,174,13584,350,176
226,41,68,225.0,40.0,177,15027,329,152
221,38,68,225.0,40.0,169,13939,312,143
227,36,68,225.0,40.0,173,13223,306,133
225,38,68,225.0,40.0,173,13943,335,162
223,39,68,225.0,40.0,172,14302,352,180
233,36,69,235.0,40.0,179,13229,942,763
238,41,69,235.0,40.0,189,15039,335,146
236,44,69,235.0,40.0,190,16120,318,128
234,41,69,235.0,40.0,185,15035,324,139
235,35,69,235.0,40.0,180,12870,334,154
237,39,69,235.0,40.0,186,14316,860,674
231,35,69,235.0,40.0,176,12866,323,147
231,37,69,235.0,40.0,178,13588,307,129
235,42,69,235.0,40.0,187,15397,343,156
235,43,69,235.0,40.0,188,15758,327,139
245,35,70,245.0,40.0,190,12880,339,149
241,36,70,245.0,40.0,187,13237,352,165
246,41,70,245.0,40.0,197,15047,337,140
246,44,70,245.0,40.0,200,16130,352,152
247,37,70,245.0,40.0,194,13604,324,130
241,44,70,245.0,40.0,195,16125,327,132
240,39,70,245.0,40.0,189,14319,369,180
242,35,70,245.0,40.0,187,12877,328,141
243,42,70,245.0,40.0,195,15405,340,145
240,41,70,245.0,40.0,191,15041,342,151
253,43,71,255.0,40.0,206,15776,351,145
258,39,71,255.0,40.0,207,14337,372,165
253,42,71,255.0,40.0,205,15415,360,155
250,42,71,255.0,40.0,202,15412,334,132
259,39,71,255.0,40.0,208,14338,646,438
257,39,71,255.0,40.0,206,14336,391,185
259,40,71,255.0,40.0,209,14699,392,183
251,40,71,255.0,40.0,201,14691,332,131
255,38,71,255.0,40.0,203,13973,370,167
255,40,71,255.0,40.0,205,14695,355,150
260,36,72,265.0,40.0,206,13256,338,132
264,40,72,265.0,40.0,214,14704,394,180
267,44,72,265.0,40.0,221,16151,367,146
262,41,72,265.0,40.0,213,15063,354,141
268,35,72,265.0,40.0,213,12903,346,133
265,44,72,265.0,40.0,219,16149,351,132
267,40,72,265.0,40.0,217,14707,366,149
261,36,72,265.0,40.0,207,13257,350,143
260,36,72,265.0,40.0,206,13256,339,133
263,41,72,265.0,40.0,214,15064,378,164
276,44,73,275.0,40.0,230,16160,366,136
273,44,73,275.0,40.0,227,16157,359,132
279,41,73,275.0,40.0,230,15080,381,151
274,41,73,275.0,40.0,225,15075,364,139
273,38,73,275.0,40.0,221,13991,369,148
272,44,73,275.0,40.0,226,16156,363,137
273,43,73,275.0,40.0,226,15796,354,128
277,43,73,275.0,40.0,230,15800,386,156
276,42,73,275.0,40.0,228,15438,359,131
273,41,73,275.0,40.0,224,15074,364,140
285,43,74,285.0,40.0,238,15808,385,147
284,43,74,285.0,40.0,237,15807,380,143
282,41,74,285.0,40.0,233,15083,401,168
284,42,74,285.0,40.0,236,15446,375,139
284,39,74,285.0,40.0,233,14363,393,160
286,40,74,285.0,40.0,236,14726,380,144
288,40,74,285.0,40.0,238,14728,396,158
286,40,74,285.0,40.0,236,14726,391,155
282,43,74,285.0,40.0,235,15805,384,149
285,37,74,285.0,40.0,232,13642,397,165
293,36,75,295.0,40.0,239,13289,385,146
299,41,75,295.0,40.0,250,15100,390,140
293,42,75,295.0,40.0,245,15455,386,141
296,44,75,295.0,40.0,250,16180,409,159
294,38,75,295.0,40.0,242,14012,548,306
294,43,75,295.0,40.0,247,15817,542,295
297,37,75,295.0,40.0,244,13654,383,139
291,43,75,295.0,40.0,244,15814,408,164
290,40,75,295.0,40.0,240,14730,556,316
299,40,75,295.0,40.0,249,14739,395,146
306,39,76,305.0,40.0,255,14385,535,280
308,37,76,305.0,40.0,255,13665,410,155
301,35,76,305.0,40.0,246,12936,391,145
302,36,76,305.0,40.0,248,13298,406,158
303,41,76,305.0,40.0,254,15104,413,159
303,38,76,305.0,40.0,251,14021,401,150
307,38,76,305.0,40.0,255,14025,406,151
307,36,76,305.0,40.0,253,13303,403,150
301,42,76,305.0,40.0,253,15463,403,150
300,43,76,305.0,40.0,253,15823,382,129
310,41,77,312.5,40.0,261,15111,397,136
312,44,77,312.5,40.0,266,16196,411,145
310,35,77,312.5,40.0,255,12945,1001,746
311,37,77,312.5,40.0,258,13668,415,157
314,38,77,312.5,40.0,262,14032,560,298
312,42,77,312.5,40.0,264,15474,542,278
311,44,77,312.5,40.0,265,16195,418,153
311,40,77,312.5,40.0,261,14751,419,158
311,44,77,312.5,40.0,265,16195,535,270
310,39,77,312.5,40.0,259,14389,400,141
