x,y,cell,cell_x,cell_y,opt_traj,point_id,steps_taken,extra_steps
63,21,0,65.0,20.0,12,7644,27,15
65,24,0,65.0,20.0,11,8729,37,26
65,22,0,65.0,20.0,13,8007,35,22
60,22,0,65.0,20.0,8,8002,23,15
62,15,0,65.0,20.0,17,5477,98,81
62,21,0,65.0,20.0,11,7643,42,31
64,15,0,65.0,20.0,19,5479,100,81
64,16,0,65.0,20.0,18,5840,108,90
66,23,0,65.0,20.0,13,8369,52,39
65,19,0,65.0,20.0,16,6924,39,23
70,17,1,75.0,20.0,23,6207,47,24
79,18,1,75.0,20.0,31,6577,67,36
76,22,1,75.0,20.0,24,8018,48,24
74,24,1,75.0,20.0,20,8738,49,29
70,18,1,75.0,20.0,22,6568,53,31
70,20,1,75.0,20.0,20,7290,35,15
79,15,1,75.0,20.0,34,5494,67,33
76,21,1,75.0,20.0,25,7657,64,39
79,23,1,75.0,20.0,26,8382,46,20
78,18,1,75.0,20.0,30,6576,46,16
80,22,2,85.0,20.0,28,8022,62,34
82,17,2,85.0,20.0,35,6219,67,32
88,19,2,85.0,20.0,39,6947,56,17
88,18,2,85.0,20.0,40,6586,87,47
86,20,2,85.0,20.0,36,7306,95,59
89,24,2,85.0,20.0,35,8753,79,44
83,20,2,85.0,20.0,33,7303,84,51
81,16,2,85.0,20.0,35,5857,72,37
81,18,2,85.0,20.0,33,6579,73,40
87,15,2,85.0,20.0,42,5502,63,21
96,22,3,95.0,20.0,44,8038,99,55
91,23,3,95.0,20.0,38,8394,78,40
90,20,3,95.0,20.0,40,7310,74,34
93,20,3,95.0,20.0,43,7313,84,41
97,17,3,95.0,20.0,50,6234,113,63
95,19,3,95.0,20.0,46,6954,84,38
94,19,3,95.0,20.0,45,6953,64,19
98,17,3,95.0,20.0,51,6235,142,91
93,20,3,95.0,20.0,43,7313,98,55
99,15,3,95.0,20.0,54,5514,111,57
101,22,4,105.0,20.0,49,8043,99,50
105,22,4,105.0,20.0,53,8047,126,73
107,19,4,105.0,20.0,58,6966,118,60
106,17,4,105.0,20.0,59,6243,177,118
106,15,4,105.0,20.0,61,5521,181,120
102,21,4,105.0,20.0,51,7683,121,70
103,19,4,105.0,20.0,54,6962,72,18
106,18,4,105.0,20.0,58,6604,116,58
101,16,4,105.0,20.0,55,5877,80,25
103,16,4,105.0,20.0,57,5879,100,43
118,16,5,115.0,20.0,72,5894,194,122
117,24,5,115.0,20.0,63,8781,118,55
114,23,5,115.0,20.0,61,8417,208,147
112,24,5,115.0,20.0,58,8776,388,330
111,21,5,115.0,20.0,60,7692,157,97
115,24,5,115.0,20.0,61,8779,181,120
116,18,5,115.0,20.0,68,6614,134,66
115,23,5,115.0,20.0,62,8418,188,126
110,16,5,115.0,20.0,64,5886,120,56
112,21,5,115.0,20.0,61,7693,128,67
127,22,6,125.0,20.0,75,8069,204,129
129,23,6,125.0,20.0,76,8432,439,363
121,20,6,125.0,20.0,71,7341,195,124
122,19,6,125.0,20.0,73,6981,187,114
125,16,6,125.0,20.0,79,5901,182,103
129,20,6,125.0,20.0,79,7349,191,112
122,18,6,125.0,20.0,74,6620,189,115
129,23,6,125.0,20.0,76,8432,197,121
128,16,6,125.0,20.0,82,5904,190,108
126,17,6,125.0,20.0,79,6263,200,121
132,21,7,135.0,20.0,81,7713,211,130
137,18,7,135.0,20.0,89,6635,212,123
132,16,7,135.0,20.0,86,5908,190,104
130,17,7,135.0,20.0,83,6267,206,123
131,16,7,135.0,20.0,85,5907,198,113
133,24,7,135.0,20.0,79,8797,229,150
132,24,7,135.0,20.0,78,8796,333,255
130,20,7,135.0,20.0,80,7350,209,129
139,21,7,135.0,20.0,88,7720,275,187
130,17,7,135.0,20.0,83,6267,190,107
141,23,8,145.0,20.0,88,8444,192,104
143,20,8,145.0,20.0,93,7363,289,196
144,19,8,145.0,20.0,95,7003,204,109
145,20,8,145.0,20.0,95,7365,208,113
147,23,8,145.0,20.0,94,8450,211,117
149,22,8,145.0,20.0,97,8091,226,129
148,23,8,145.0,20.0,95,8451,261,166
149,22,8,145.0,20.0,97,8091,227,130
144,20,8,145.0,20.0,94,7364,278,184
143,15,8,145.0,20.0,98,5558,181,83
150,19,9,155.0,20.0,101,7009,217,116
150,19,9,155.0,20.0,101,7009,218,117
157,17,9,155.0,20.0,110,6294,199,89
150,24,9,155.0,20.0,96,8814,218,122
150,22,9,155.0,20.0,98,8092,243,145
151,17,9,155.0,20.0,104,6288,222,118
153,18,9,155.0,20.0,105,6651,223,118
150,19,9,155.0,20.0,101,7009,212,111
155,15,9,155.0,20.0,110,5570,234,124
158,18,9,155.0,20.0,110,6656,201,91
167,21,10,165.0,20.0,116,7748,252,136
165,15,10,165.0,20.0,120,5580,529,409
164,21,10,165.0,20.0,113,7745,284,171
161,20,10,165.0,20.0,111,7381,233,122
164,22,10,165.0,20.0,112,8106,265,153
166,20,10,165.0,20.0,116,7386,288,172
163,21,10,165.0,20.0,112,7744,219,107
163,24,10,165.0,20.0,109,8827,216,107
169,22,10,165.0,20.0,117,8111,278,161
163,24,10,165.0,20.0,109,8827,234,125
170,18,11,175.0,20.0,122,6668,328,206
172,18,11,175.0,20.0,124,6670,1001,877
172,20,11,175.0,20.0,122,7392,275,153
175,22,11,175.0,20.0,123,8117,284,161
179,24,11,175.0,20.0,125,8843,238,113
172,19,11,175.0,20.0,123,7031,366,243
170,15,11,175.0,20.0,125,5585,1001,876
178,21,11,175.0,20.0,127,7759,335,208
175,16,11,175.0,20.0,129,5951,1001,872
171,16,11,175.0,20.0,125,5947,388,263
185,22,12,185.0,20.0,133,8127,245,112
187,24,12,185.0,20.0,133,8851,243,110
184,21,12,185.0,20.0,133,7765,289,156
189,20,12,185.0,20.0,139,7409,344,205
189,21,12,185.0,20.0,138,7770,257,119
186,18,12,185.0,20.0,138,6684,265,127
185,22,12,185.0,20.0,133,8127,323,190
187,16,12,185.0,20.0,141,5963,1001,860
185,19,12,185.0,20.0,136,7044,372,236
182,23,12,185.0,20.0,129,8485,361,232
196,22,13,195.0,20.0,144,8138,286,142
194,20,13,195.0,20.0,144,7414,319,175
191,21,13,195.0,20.0,140,7772,314,174
191,16,13,195.0,20.0,145,5967,717,572
195,17,13,195.0,20.0,148,6332,731,583
196,18,13,195.0,20.0,148,6694,322,174
193,23,13,195.0,20.0,140,8496,313,173
195,15,13,195.0,20.0,150,5610,724,574
194,24,13,195.0,20.0,140,8858,294,154
199,22,13,195.0,20.0,147,8141,294,147
207,18,14,205.0,20.0,159,6705,363,204
207,16,14,205.0,20.0,161,5983,701,540
203,24,14,205.0,20.0,149,8867,311,162
202,20,14,205.0,20.0,152,7422,271,119
205,19,14,205.0,20.0,156,7064,285,129
207,21,14,205.0,20.0,156,7788,308,152
204,24,14,205.0,20.0,150,8868,259,109
208,15,14,205.0,20.0,163,5623,711,548
205,19,14,205.0,20.0,156,7064,283,127
203,21,14,205.0,20.0,152,7784,317,165
212,18,15,215.0,20.0,164,6710,712,548
217,17,15,215.0,20.0,170,6354,408,238
215,15,15,215.0,20.0,170,5630,698,528
215,17,15,215.0,20.0,168,6352,708,540
212,23,15,215.0,20.0,159,8515,323,164
218,19,15,215.0,20.0,169,7077,314,145
215,19,15,215.0,20.0,166,7074,714,548
217,17,15,215.0,20.0,170,6354,710,540
213,21,15,215.0,20.0,162,7794,272,110
218,24,15,215.0,20.0,164,8882,273,109
225,15,16,225.0,20.0,180,5640,690,510
223,20,16,225.0,20.0,173,7443,318,145
225,20,16,225.0,20.0,175,7445,404,229
224,24,16,225.0,20.0,170,8888,282,112
227,18,16,225.0,20.0,179,6725,418,239
222,16,16,225.0,20.0,176,5998,686,510
229,18,16,225.0,20.0,181,6727,410,229
225,15,16,225.0,20.0,180,5640,391,211
221,22,16,225.0,20.0,169,8163,431,262
224,16,16,225.0,20.0,178,6000,684,506
235,17,17,235.0,20.0,188,6372,415,227
230,17,17,235.0,20.0,183,6367,392,209
230,15,17,235.0,20.0,185,5645,405,220
238,15,17,235.0,20.0,193,5653,412,219
234,17,17,235.0,20.0,187,6371,414,227
233,20,17,235.0,20.0,183,7453,426,243
233,20,17,235.0,20.0,183,7453,424,241
230,19,17,235.0,20.0,181,7089,349,168
238,18,17,235.0,20.0,190,6736,315,125
232,18,17,235.0,20.0,184,6730,400,216
241,17,18,245.0,20.0,194,6378,422,228
246,22,18,245.0,20.0,194,8188,433,239
242,18,18,245.0,20.0,194,6740,390,196
246,17,18,245.0,20.0,199,6383,398,199
247,24,18,245.0,20.0,193,8911,444,251
242,15,18,245.0,20.0,197,5657,403,206
241,15,18,245.0,20.0,196,5656,435,239
245,18,18,245.0,20.0,197,6743,410,213
247,24,18,245.0,20.0,193,8911,441,248
247,24,18,245.0,20.0,193,8911,433,240
257,16,19,255.0,20.0,211,6033,378,167
257,15,19,255.0,20.0,212,5672,381,169
251,15,19,255.0,20.0,206,5666,394,188
259,21,19,255.0,20.0,208,7840,403,195
250,19,19,255.0,20.0,201,7109,381,180
250,22,19,255.0,20.0,198,8192,418,220
259,19,19,255.0,20.0,210,7118,372,162
256,21,19,255.0,20.0,205,7837,418,213
256,23,19,255.0,20.0,203,8559,435,232
258,20,19,255.0,20.0,208,7478,422,214
262,21,20,265.0,20.0,211,7843,379,168
264,17,20,265.0,20.0,217,6401,375,158
260,23,20,265.0,20.0,207,8563,432,225
268,22,20,265.0,20.0,216,8210,377,161
261,15,20,265.0,20.0,216,5676,388,172
261,24,20,265.0,20.0,207,8925,480,273
265,23,20,265.0,20.0,212,8568,378,166
266,22,20,265.0,20.0,214,8208,372,158
265,19,20,265.0,20.0,216,7124,387,171
265,19,20,265.0,20.0,216,7124,406,190
276,23,21,275.0,20.0,223,8579,386,163
270,17,21,275.0,20.0,223,6407,398,175
278,22,21,275.0,20.0,226,8220,412,186
271,16,21,275.0,20.0,225,6047,405,180
275,24,21,275.0,20.0,221,8939,382,161
270,20,21,275.0,20.0,220,7490,410,190
279,19,21,275.0,20.0,230,7138,453,223
278,16,21,275.0,20.0,232,6054,391,159
270,20,21,275.0,20.0,220,7490,377,157
272,15,21,275.0,20.0,227,5687,393,166
288,21,22,285.0,20.0,237,7869,400,163
280,18,22,285.0,20.0,232,6778,434,202
280,18,22,285.0,20.0,232,6778,389,157
287,16,22,285.0,20.0,241,6063,540,299
283,20,22,285.0,20.0,233,7503,418,185
282,21,22,285.0,20.0,231,7863,392,161
288,20,22,285.0,20.0,238,7508,397,159
286,18,22,285.0,20.0,238,6784,418,180
280,23,22,285.0,20.0,227,8583,409,182
280,19,22,285.0,20.0,231,7139,398,167
298,17,23,295.0,20.0,251,6435,553,302
296,19,23,295.0,20.0,247,7155,594,347
296,21,23,295.0,20.0,245,7877,446,201
298,24,23,295.0,20.0,244,8962,546,302
290,21,23,295.0,20.0,239,7871,397,158
299,20,23,295.0,20.0,249,7519,482,233
299,17,23,295.0,20.0,252,6436,417,165
290,19,23,295.0,20.0,241,7149,426,185
294,22,23,295.0,20.0,242,8236,419,177
293,20,23,295.0,20.0,243,7513,407,164
307,19,24,305.0,20.0,258,7166,497,239
309,17,24,305.0,20.0,262,6446,465,203
307,17,24,305.0,20.0,260,6444,478,218
305,22,24,305.0,20.0,253,8247,460,207
300,23,24,305.0,20.0,247,8603,589,342
308,23,24,305.0,20.0,255,8611,422,167
305,22,24,305.0,20.0,253,8247,469,216
302,19,24,305.0,20.0,253,7161,435,182
303,23,24,305.0,20.0,250,8606,555,305
303,20,24,305.0,20.0,253,7523,445,192
314,23,25,312.5,20.0,261,8617,1001,740
310,23,25,312.5,20.0,257,8613,447,190
310,23,25,312.5,20.0,257,8613,436,179
311,19,25,312.5,20.0,262,7170,467,205
310,23,25,312.5,20.0,257,8613,570,313
310,15,25,312.5,20.0,265,5725,567,302
312,18,25,312.5,20.0,264,6810,590,326
311,15,25,312.5,20.0,266,5726,568,302
313,16,25,312.5,20.0,267,6089,581,314
313,19,25,312.5,20.0,264,7172,465,201
67,26,26,65.0,30.0,11,9453,29,18
65,26,26,65.0,30.0,9,9451,57,48
65,30,26,65.0,30.0,5,10895,21,16
66,30,26,65.0,30.0,6,10896,9,3
63,26,26,65.0,30.0,7,9449,44,37
66,30,26,65.0,30.0,6,10896,9,3
67,33,26,65.0,30.0,10,11980,19,9
67,31,26,65.0,30.0,8,11258,25,17
64,32,26,65.0,30.0,6,11616,20,14
63,30,26,65.0,30.0,3,10893,6,3
71,29,27,75.0,30.0,12,10540,57,45
76,25,27,75.0,30.0,21,9101,51,30
79,28,27,75.0,30.0,21,10187,88,67
77,30,27,75.0,30.0,17,10907,59,42
77,34,27,75.0,30.0,21,12351,46,25
76,26,27,75.0,30.0,20,9462,58,38
78,34,27,75.0,30.0,22,12352,37,15
78,31,27,75.0,30.0,19,11269,38,19
75,31,27,75.0,30.0,16,11266,50,34
78,34,27,75.0,30.0,22,12352,35,13
88,26,28,85.0,30.0,32,9474,64,32
85,26,28,85.0,30.0,29,9471,62,33
86,34,28,85.0,30.0,30,12360,54,24
87,25,28,85.0,30.0,32,9112,75,43
85,31,28,85.0,30.0,26,11276,74,48
84,30,28,85.0,30.0,24,10914,115,91
81,26,28,85.0,30.0,25,9467,185,160
86,26,28,85.0,30.0,30,9472,98,68
85,32,28,85.0,30.0,27,11637,76,49
89,32,28,85.0,30.0,31,11641,59,28
97,32,29,95.0,30.0,39,11649,98,59
93,30,29,95.0,30.0,33,10923,82,49
96,31,29,95.0,30.0,37,11287,124,87
93,32,29,95.0,30.0,35,11645,63,28
96,25,29,95.0,30.0,41,9121,103,62
93,32,29,95.0,30.0,35,11645,106,71
94,34,29,95.0,30.0,38,12368,80,42
92,34,29,95.0,30.0,36,12366,100,64
94,28,29,95.0,30.0,36,10202,76,40
96,33,29,95.0,30.0,39,12009,62,23
109,31,30,105.0,30.0,50,11300,119,69
101,33,30,105.0,30.0,44,12014,110,66
106,28,30,105.0,30.0,48,10214,189,141
103,25,30,105.0,30.0,48,9128,111,63
100,30,30,105.0,30.0,40,10930,262,222
105,32,30,105.0,30.0,47,11657,107,60
109,29,30,105.0,30.0,50,10578,978,928
109,28,30,105.0,30.0,51,10217,87,36
104,27,30,105.0,30.0,47,9851,76,29
106,30,30,105.0,30.0,46,10936,87,41
110,33,31,115.0,30.0,53,12023,162,109
113,31,31,115.0,30.0,54,11304,125,71
118,29,31,115.0,30.0,59,10587,640,581
115,32,31,115.0,30.0,57,11667,442,385
119,27,31,115.0,30.0,62,9866,597,535
112,32,31,115.0,30.0,54,11664,73,19
115,34,31,115.0,30.0,59,12389,115,56
114,26,31,115.0,30.0,58,9500,202,144
118,34,31,115.0,30.0,62,12392,104,42
119,31,31,115.0,30.0,60,11310,296,236
127,29,32,125.0,30.0,68,10596,292,224
122,29,32,125.0,30.0,63,10591,593,530
123,29,32,125.0,30.0,64,10592,893,829
124,31,32,125.0,30.0,65,11315,876,811
121,28,32,125.0,30.0,63,10229,189,126
124,34,32,125.0,30.0,68,12398,325,257
127,34,32,125.0,30.0,71,12401,889,818
121,26,32,125.0,30.0,65,9507,200,135
123,29,32,125.0,30.0,64,10592,305,241
123,32,32,125.0,30.0,65,11675,885,820
139,29,33,135.0,30.0,80,10608,248,168
139,32,33,135.0,30.0,81,11691,830,749
130,31,33,135.0,30.0,71,11321,861,790
130,25,33,135.0,30.0,75,9155,193,118
135,34,33,135.0,30.0,79,12409,857,778
134,33,33,135.0,30.0,77,12047,857,780
139,28,33,135.0,30.0,81,10247,359,278
131,28,33,135.0,30.0,73,10239,396,323
133,30,33,135.0,30.0,73,10963,874,801
133,30,33,135.0,30.0,73,10963,236,163
149,28,34,145.0,30.0,91,10257,324,233
143,29,34,145.0,30.0,84,10612,219,135
149,32,34,145.0,30.0,91,11701,830,739
141,30,34,145.0,30.0,81,10971,813,732
142,25,34,145.0,30.0,87,9167,219,132
142,28,34,145.0,30.0,84,10250,212,128
142,28,34,145.0,30.0,84,10250,228,144
140,32,34,145.0,30.0,82,11692,823,741
144,34,34,145.0,30.0,88,12418,800,712
149,34,34,145.0,30.0,93,12423,835,742
150,25,35,155.0,30.0,95,9175,228,133
159,29,35,155.0,30.0,100,10628,250,150
159,28,35,155.0,30.0,101,10267,313,212
154,25,35,155.0,30.0,99,9179,249,150
155,26,35,155.0,30.0,99,9541,233,134
150,29,35,155.0,30.0,91,10619,260,169
158,31,35,155.0,30.0,99,11349,822,723
150,25,35,155.0,30.0,95,9175,281,186
155,26,35,155.0,30.0,99,9541,278,179
152,26,35,155.0,30.0,96,9538,207,111
168,33,36,165.0,30.0,111,12081,324,213
165,32,36,165.0,30.0,107,11717,797,690
166,34,36,165.0,30.0,110,12440,806,696
163,29,36,165.0,30.0,104,10632,254,150
166,29,36,165.0,30.0,107,10635,228,121
161,28,36,165.0,30.0,103,10269,238,135
168,33,36,165.0,30.0,111,12081,830,719
167,28,36,165.0,30.0,109,10275,248,139
163,27,36,165.0,30.0,106,9910,233,127
166,30,36,165.0,30.0,106,10996,236,130
179,27,37,175.0,30.0,122,9926,254,132
176,33,37,175.0,30.0,119,12089,757,638
178,33,37,175.0,30.0,121,12091,246,125
175,25,37,175.0,30.0,120,9200,236,116
175,30,37,175.0,30.0,115,11005,775,660
173,27,37,175.0,30.0,116,9920,269,153
174,32,37,175.0,30.0,116,11726,750,634
173,26,37,175.0,30.0,117,9559,258,141
178,25,37,175.0,30.0,123,9203,233,110
179,25,37,175.0,30.0,124,9204,234,110
182,33,38,185.0,30.0,125,12095,271,146
182,29,38,185.0,30.0,123,10651,256,133
180,34,38,185.0,30.0,124,12454,264,140
188,29,38,185.0,30.0,129,10657,308,179
180,33,38,185.0,30.0,123,12093,257,134
189,31,38,185.0,30.0,130,11380,325,195
185,27,38,185.0,30.0,128,9932,253,125
185,34,38,185.0,30.0,129,12459,325,196
183,29,38,185.0,30.0,124,10652,273,149
184,30,38,185.0,30.0,124,11014,457,333
192,28,39,195.0,30.0,134,10300,283,149
196,27,39,195.0,30.0,139,9943,266,127
197,30,39,195.0,30.0,137,11027,400,263
198,29,39,195.0,30.0,139,10667,308,169
195,33,39,195.0,30.0,138,12108,283,145
199,30,39,195.0,30.0,139,11029,268,129
195,27,39,195.0,30.0,138,9942,302,164
194,28,39,195.0,30.0,136,10302,286,150
197,27,39,195.0,30.0,140,9944,266,126
190,25,39,195.0,30.0,135,9215,251,116
207,32,40,205.0,30.0,149,11759,356,207
209,33,40,205.0,30.0,152,12122,293,141
205,28,40,205.0,30.0,147,10313,313,166
209,33,40,205.0,30.0,152,12122,311,159
209,28,40,205.0,30.0,151,10317,297,146
209,28,40,205.0,30.0,151,10317,308,157
201,33,40,205.0,30.0,144,12114,275,131
202,28,40,205.0,30.0,144,10310,326,182
209,34,40,205.0,30.0,153,12483,431,278
201,34,40,205.0,30.0,145,12475,286,141
212,34,41,215.0,30.0,156,12486,316,160
217,33,41,215.0,30.0,160,12130,287,127
216,25,41,215.0,30.0,161,9241,398,237
213,32,41,215.0,30.0,155,11765,288,133
216,33,41,215.0,30.0,159,12129,336,177
217,29,41,215.0,30.0,158,10686,337,179
219,27,41,215.0,30.0,162,9966,318,156
216,27,41,215.0,30.0,159,9963,291,132
214,30,41,215.0,30.0,154,11044,286,132
211,27,41,215.0,30.0,154,9958,317,163
229,25,42,225.0,30.0,174,9254,443,269
228,28,42,225.0,30.0,170,10336,336,166
227,26,42,225.0,30.0,171,9613,287,116
226,34,42,225.0,30.0,170,12500,342,172
225,29,42,225.0,30.0,166,10694,342,176
229,27,42,225.0,30.0,172,9976,443,271
223,28,42,225.0,30.0,165,10331,330,165
228,30,42,225.0,30.0,168,11058,570,402
225,25,42,225.0,30.0,170,9250,344,174
228,29,42,225.0,30.0,169,10697,351,182
230,25,43,235.0,30.0,175,9255,351,176
235,33,43,235.0,30.0,178,12148,478,300
237,26,43,235.0,30.0,181,9623,467,286
235,30,43,235.0,30.0,175,11065,299,124
231,34,43,235.0,30.0,175,12505,367,192
233,29,43,235.0,30.0,174,10702,462,288
231,28,43,235.0,30.0,173,10339,294,121
233,32,43,235.0,30.0,175,11785,371,196
236,26,43,235.0,30.0,180,9622,462,282
236,33,43,235.0,30.0,179,12149,463,284
243,31,44,245.0,30.0,184,11434,465,281
242,25,44,245.0,30.0,187,9267,453,266
241,28,44,245.0,30.0,183,10349,470,287
247,33,44,245.0,30.0,190,12160,506,316
242,31,44,245.0,30.0,183,11433,463,280
242,25,44,245.0,30.0,187,9267,447,260
245,34,44,245.0,30.0,189,12519,459,270
248,27,44,245.0,30.0,191,9995,594,403
242,33,44,245.0,30.0,185,12155,480,295
241,26,44,245.0,30.0,185,9627,448,263
253,30,45,255.0,30.0,193,11083,497,304
257,27,45,255.0,30.0,200,10004,487,287
257,32,45,255.0,30.0,199,11809,355,156
251,34,45,255.0,30.0,195,12525,500,305
254,31,45,255.0,30.0,195,11445,513,318
255,26,45,255.0,30.0,199,9641,547,348
251,30,45,255.0,30.0,191,11081,538,347
252,32,45,255.0,30.0,194,11804,513,319
257,30,45,255.0,30.0,197,11087,352,155
257,33,45,255.0,30.0,200,12170,350,150
268,26,46,265.0,30.0,212,9654,369,157
268,29,46,265.0,30.0,209,10737,364,155
262,30,46,265.0,30.0,202,11092,388,186
261,33,46,265.0,30.0,204,12174,385,181
266,32,46,265.0,30.0,208,11818,384,176
265,32,46,265.0,30.0,207,11817,358,151
260,28,46,265.0,30.0,202,10368,400,198
262,33,46,265.0,30.0,205,12175,368,163
262,33,46,265.0,30.0,205,12175,390,185
269,29,46,265.0,30.0,210,10738,365,155
271,31,47,275.0,30.0,212,11462,380,168
271,32,47,275.0,30.0,213,11823,382,169
279,29,47,275.0,30.0,220,10748,390,170
276,25,47,275.0,30.0,221,9301,390,169
278,29,47,275.0,30.0,219,10747,399,180
276,26,47,275.0,30.0,220,9662,377,157
277,26,47,275.0,30.0,221,9663,399,178
279,31,47,275.0,30.0,220,11470,376,156
273,32,47,275.0,30.0,215,11825,393,178
274,26,47,275.0,30.0,218,9660,681,463
282,33,48,285.0,30.0,225,12195,386,161
281,32,48,285.0,30.0,223,11833,457,234
284,33,48,285.0,30.0,227,12197,434,207
282,30,48,285.0,30.0,222,11112,419,197
285,33,48,285.0,30.0,228,12198,500,272
280,33,48,285.0,30.0,223,12193,420,197
280,25,48,285.0,30.0,225,9305,419,194
285,32,48,285.0,30.0,227,11837,529,302
285,25,48,285.0,30.0,230,9310,402,172
288,25,48,285.0,30.0,233,9313,429,196
294,30,49,295.0,30.0,234,11124,428,194
293,27,49,295.0,30.0,236,10040,394,158
292,33,49,295.0,30.0,235,12205,523,288
291,26,49,295.0,30.0,235,9677,391,156
293,32,49,295.0,30.0,235,11845,419,184
298,31,49,295.0,30.0,239,11489,519,280
298,28,49,295.0,30.0,240,10406,470,230
296,31,49,295.0,30.0,237,11487,391,154
298,33,49,295.0,30.0,241,12211,539,298
298,33,49,295.0,30.0,241,12211,411,170
300,25,50,305.0,30.0,245,9325,409,164
305,28,50,305.0,30.0,247,10413,442,195
301,29,50,305.0,30.0,242,10770,454,212
301,27,50,305.0,30.0,244,10048,448,204
304,30,50,305.0,30.0,244,11134,426,182
300,27,50,305.0,30.0,243,10047,401,158
300,25,50,305.0,30.0,245,9325,568,323
308,29,50,305.0,30.0,249,10777,537,288
306,34,50,305.0,30.0,250,12580,577,327
307,30,50,305.0,30.0,247,11137,549,302
310,25,51,312.5,30.0,255,9335,422,167
313,28,51,312.5,30.0,255,10421,568,313
313,34,51,312.5,30.0,257,12587,565,308
311,26,51,312.5,30.0,255,9697,585,330
310,32,51,312.5,30.0,252,11862,542,290
313,26,51,312.5,30.0,257,9699,580,323
313,25,51,312.5,30.0,258,9338,574,316
311,25,51,312.5,30.0,256,9336,587,331
313,29,51,312.5,30.0,254,10782,457,203
310,29,51,312.5,30.0,251,10779,577,326
67,43,52,65.0,40.0,20,15590,61,41
63,44,52,65.0,40.0,17,15947,77,60
60,40,52,65.0,40.0,10,14500,215,205
66,37,52,65.0,40.0,13,13423,24,11
61,43,52,65.0,40.0,14,15584,333,319
61,36,52,65.0,40.0,7,13057,21,14
61,43,52,65.0,40.0,14,15584,55,41
62,44,52,65.0,40.0,16,15946,96,80
60,39,52,65.0,40.0,9,14139,42,33
66,38,52,65.0,40.0,14,13784,20,6
71,40,53,75.0,40.0,21,14511,79,58
71,38,53,75.0,40.0,19,13789,38,19
74,44,53,75.0,40.0,28,15958,170,142
70,41,53,75.0,40.0,21,14871,69,48
77,44,53,75.0,40.0,31,15961,324,293
70,40,53,75.0,40.0,20,14510,61,41
72,37,53,75.0,40.0,19,13429,21,2
73,44,53,75.0,40.0,27,15957,337,310
77,36,53,75.0,40.0,23,13073,67,44
71,43,53,75.0,40.0,24,15594,80,56
84,36,54,85.0,40.0,30,13080,32,2
82,41,54,85.0,40.0,33,14883,109,76
87,36,54,85.0,40.0,33,13083,43,10
80,44,54,85.0,40.0,34,15964,86,52
80,42,54,85.0,40.0,32,15242,215,183
84,38,54,85.0,40.0,32,13802,85,53
83,38,54,85.0,40.0,31,13801,65,34
84,38,54,85.0,40.0,32,13802,142,110
80,44,54,85.0,40.0,34,15964,99,65
83,38,54,85.0,40.0,31,13801,48,17
92,39,55,95.0,40.0,41,14171,62,21
91,43,55,95.0,40.0,44,15614,138,94
98,41,55,95.0,40.0,49,14899,95,46
91,37,55,95.0,40.0,38,13448,72,34
92,43,55,95.0,40.0,45,15615,93,48
94,42,55,95.0,40.0,46,15256,97,51
91,38,55,95.0,40.0,39,13809,50,11
93,44,55,95.0,40.0,47,15977,125,78
94,44,55,95.0,40.0,48,15978,90,42
93,41,55,95.0,40.0,44,14894,140,96
103,43,56,105.0,40.0,56,15626,125,69
106,41,56,105.0,40.0,57,14907,89,32
109,42,56,105.0,40.0,61,15271,171,110
103,43,56,105.0,40.0,56,15626,113,57
105,39,56,105.0,40.0,54,14184,97,43
100,40,56,105.0,40.0,50,14540,109,59
100,44,56,105.0,40.0,54,15984,124,70
102,36,56,105.0,40.0,48,13098,74,26
100,43,56,105.0,40.0,53,15623,130,77
105,36,56,105.0,40.0,51,13101,56,5
113,44,57,115.0,40.0,67,15997,110,43
117,44,57,115.0,40.0,71,16001,148,77
119,43,57,115.0,40.0,72,15642,915,843
117,35,57,115.0,40.0,62,12752,121,59
111,41,57,115.0,40.0,62,14912,139,77
117,38,57,115.0,40.0,65,13835,140,75
114,40,57,115.0,40.0,64,14554,119,55
110,36,57,115.0,40.0,56,13106,59,3
119,40,57,115.0,40.0,69,14559,130,61
118,43,57,115.0,40.0,71,15641,901,830
127,36,58,125.0,40.0,73,13123,867,794
121,41,58,125.0,40.0,72,14922,904,832
129,43,58,125.0,40.0,82,15652,908,826
128,40,58,125.0,40.0,78,14568,872,794
129,35,58,125.0,40.0,74,12764,903,829
127,44,58,125.0,40.0,81,16011,912,831
124,35,58,125.0,40.0,69,12759,875,806
128,39,58,125.0,40.0,77,14207,871,794
122,41,58,125.0,40.0,73,14923,908,835
121,38,58,125.0,40.0,69,13839,906,837
132,44,59,135.0,40.0,86,16016,919,833
139,41,59,135.0,40.0,90,14940,856,766
130,44,59,135.0,40.0,84,16014,866,782
135,38,59,135.0,40.0,83,13853,835,752
130,37,59,135.0,40.0,77,13487,841,764
137,40,59,135.0,40.0,87,14577,842,755
139,38,59,135.0,40.0,87,13857,826,739
132,37,59,135.0,40.0,79,13489,878,799
137,44,59,135.0,40.0,91,16021,831,740
133,40,59,135.0,40.0,83,14573,842,759
143,40,60,145.0,40.0,93,14583,846,753
144,35,60,145.0,40.0,89,12779,824,735
144,43,60,145.0,40.0,97,15667,847,750
144,42,60,145.0,40.0,96,15306,840,744
140,37,60,145.0,40.0,87,13497,834,747
142,40,60,145.0,40.0,92,14582,825,733
141,38,60,145.0,40.0,89,13859,852,763
144,41,60,145.0,40.0,95,14945,851,756
145,39,60,145.0,40.0,94,14224,837,743
147,42,60,145.0,40.0,99,15309,856,757
154,42,61,155.0,40.0,106,15316,863,757
158,36,61,155.0,40.0,104,13154,810,706
158,39,61,155.0,40.0,107,14237,842,735
159,35,61,155.0,40.0,104,12794,814,710
157,43,61,155.0,40.0,110,15680,865,755
156,37,61,155.0,40.0,103,13513,805,702
150,36,61,155.0,40.0,96,13146,817,721
157,41,61,155.0,40.0,108,14958,835,727
154,35,61,155.0,40.0,99,12789,789,690
152,37,61,155.0,40.0,99,13509,839,740
167,39,62,165.0,40.0,116,14246,797,681
168,36,62,165.0,40.0,114,13164,794,680
164,39,62,165.0,40.0,113,14243,775,662
166,37,62,165.0,40.0,113,13523,793,680
161,39,62,165.0,40.0,110,14240,778,668
160,41,62,165.0,40.0,111,14961,817,706
164,38,62,165.0,40.0,112,13882,777,665
163,38,62,165.0,40.0,111,13881,783,672
163,37,62,165.0,40.0,110,13520,787,677
162,35,62,165.0,40.0,107,12797,803,696
176,44,63,175.0,40.0,130,16060,774,644
172,37,63,175.0,40.0,119,13529,762,643
174,39,63,175.0,40.0,123,14253,794,671
176,42,63,175.0,40.0,128,15338,791,663
175,40,63,175.0,40.0,125,14615,788,663
179,41,63,175.0,40.0,130,14980,779,649
171,43,63,175.0,40.0,124,15694,772,648
173,39,63,175.0,40.0,122,14252,783,661
173,43,63,175.0,40.0,126,15696,777,651
178,36,63,175.0,40.0,124,13174,250,126
181,44,64,185.0,40.0,135,16065,790,655
180,36,64,185.0,40.0,126,13176,274,148
181,43,64,185.0,40.0,134,15704,776,642
186,36,64,185.0,40.0,132,13182,270,138
189,41,64,185.0,40.0,140,14990,295,155
180,36,64,185.0,40.0,126,13176,289,163
189,41,64,185.0,40.0,140,14990,274,134
180,37,64,185.0,40.0,127,13537,793,666
185,37,64,185.0,40.0,132,13542,268,136
181,42,64,185.0,40.0,133,15343,298,165
197,43,65,195.0,40.0,150,15720,290,140
198,41,65,195.0,40.0,149,14999,304,155
196,44,65,195.0,40.0,150,16080,301,151
195,38,65,195.0,40.0,143,13913,286,143
198,36,65,195.0,40.0,144,13194,312,168
199,37,65,195.0,40.0,146,13556,308,162
191,35,65,195.0,40.0,136,12826,271,135
194,41,65,195.0,40.0,145,14995,286,141
197,41,65,195.0,40.0,148,14998,275,127
190,41,65,195.0,40.0,141,14991,268,127
205,36,66,205.0,40.0,151,13201,306,155
204,38,66,205.0,40.0,152,13922,285,133
207,43,66,205.0,40.0,160,15730,316,156
209,42,66,205.0,40.0,161,15371,297,136
204,42,66,205.0,40.0,156,15366,335,179
204,39,66,205.0,40.0,153,14283,291,138
209,36,66,205.0,40.0,155,13205,891,736
206,39,66,205.0,40.0,155,14285,330,175
209,35,66,205.0,40.0,154,12844,280,126
202,41,66,205.0,40.0,153,15003,280,127
213,35,67,215.0,40.0,158,12848,460,302
218,42,67,215.0,40.0,170,15380,317,147
211,39,67,215.0,40.0,160,14290,330,170
215,44,67,215.0,40.0,169,16099,349,180
219,35,67,215.0,40.0,164,12854,314,150
214,44,67,215.0,40.0,168,16098,327,159
216,35,67,215.0,40.0,161,12851,341,180
218,41,67,215.0,40.0,169,15019,346,177
213,43,67,215.0,40.0,166,15736,293,127
212,42,67,215.0,40.0,164,15374,295,131
229,35,68,225.0,40.0,174,12864,308,134
226,37,68,225.0,40.0,173,13583,311,138
220,38,68,225.0,40.0,168,13938,332,164
229,42,68,225.0,40.0,181,15391,372,191
224,42,68,225.0,40.0,176,15386,356,180
227,40,68,225.0,40.0,177,14667,320,143
228,41,68,225.0,40.0,179,15029,321,142
220,40,68,225.0,40.0,170,14660,317,147
224,40,68,225.0,40.0,174,14664,310,136
227,36,68,225.0,40.0,173,13223,449,276
235,43,69,235.0,40.0,188,15758,316,128
237,39,69,235.0,40.0,186,14316,360,174
234,39,69,235.0,40.0,183,14313,334,151
232,37,69,235.0,40.0,179,13589,308,129
233,39,69,235.0,40.0,182,14312,361,179
230,36,69,235.0,40.0,176,13226,413,237
232,36,69,235.0,40.0,178,13228,305,127
231,41,69,235.0,40.0,182,15032,349,167
231,40,69,235.0,40.0,181,14671,374,193
239,43,69,235.0,40.0,192,15762,320,128
243,38,70,245.0,40.0,191,13961,344,153
241,39,70,245.0,40.0,190,14320,335,145
244,37,70,245.0,40.0,191,13601,367,176
242,36,70,245.0,40.0,188,13238,340,152
249,43,70,245.0,40.0,202,15772,330,128
241,37,70,245.0,40.0,188,13598,477,289
245,43,70,245.0,40.0,198,15768,326,128
245,43,70,245.0,40.0,198,15768,326,128
243,37,70,245.0,40.0,190,13600,391,201
244,38,70,245.0,40.0,192,13962,352,160
259,35,71,255.0,40.0,204,12894,370,166
250,35,71,255.0,40.0,195,12885,487,292
257,41,71,255.0,40.0,208,15058,370,162
252,36,71,255.0,40.0,198,13248,400,202
253,44,71,255.0,40.0,207,16137,370,163
253,36,71,255.0,40.0,199,13249,525,326
259,39,71,255.0,40.0,208,14338,347,139
253,44,71,255.0,40.0,207,16137,384,177
252,43,71,255.0,40.0,205,15775,333,128
255,40,71,255.0,40.0,205,14695,341,136
265,38,72,265.0,40.0,213,13983,370,157
264,42,72,265.0,40.0,216,15426,357,141
261,36,72,265.0,40.0,207,13257,362,155
267,38,72,265.0,40.0,215,13985,368,153
263,35,72,265.0,40.0,208,12898,364,156
264,36,72,265.0,40.0,210,13260,367,157
268,38,72,265.0,40.0,216,13986,369,153
267,44,72,265.0,40.0,221,16151,379,158
260,43,72,265.0,40.0,213,15783,341,128
260,37,72,265.0,40.0,207,13617,375,168
278,39,73,275.0,40.0,227,14357,436,209
278,44,73,275.0,40.0,232,16162,1001,769
279,42,73,275.0,40.0,231,15441,414,183
271,43,73,275.0,40.0,224,15794,390,166
278,40,73,275.0,40.0,228,14718,381,153
279,41,73,275.0,40.0,230,15080,1001,771
279,44,73,275.0,40.0,233,16163,1001,768
274,40,73,275.0,40.0,224,14714,360,136
276,41,73,275.0,40.0,227,15077,392,165
275,38,73,275.0,40.0,223,13993,380,157
287,43,74,285.0,40.0,240,15810,417,177
287,38,74,285.0,40.0,235,14005,530,295
285,40,74,285.0,40.0,235,14725,395,160
288,35,74,285.0,40.0,233,12923,430,197
289,36,74,285.0,40.0,235,13285,420,185
288,42,74,285.0,40.0,240,15450,530,290
280,43,74,285.0,40.0,233,15803,457,224
289,43,74,285.0,40.0,242,15812,538,296
288,40,74,285.0,40.0,238,14728,434,196
280,36,74,285.0,40.0,226,13276,388,162
292,35,75,295.0,40.0,237,12927,403,166
296,36,75,295.0,40.0,242,13292,471,229
295,37,75,295.0,40.0,242,13652,407,165
297,39,75,295.0,40.0,246,14376,398,152
292,38,75,295.0,40.0,240,14010,383,143
292,44,75,295.0,40.0,246,16176,534,288
291,44,75,295.0,40.0,245,16175,600,355
292,39,75,295.0,40.0,241,14371,511,270
296,39,75,295.0,40.0,245,14375,412,167
296,41,75,295.0,40.0,247,15097,538,291
300,42,76,305.0,40.0,252,15462,530,278
308,41,76,305.0,40.0,259,15109,546,287
309,35,76,305.0,40.0,254,12944,544,290
306,38,76,305.0,40.0,254,14024,470,216
300,37,76,305.0,40.0,247,13657,445,198
303,42,76,305.0,40.0,255,15465,548,293
309,40,76,305.0,40.0,259,14749,568,309
309,36,76,305.0,40.0,255,13305,586,331
300,37,76,305.0,40.0,247,13657,423,176
301,39,76,305.0,40.0,250,14380,596,346
312,43,77,312.5,40.0,265,15835,555,290
311,35,77,312.5,40.0,256,12946,581,325
314,43,77,312.5,40.0,267,15837,591,324
310,38,77,312.5,40.0,258,14028,543,285
312,41,77,312.5,40.0,263,15113,572,309
311,35,77,312.5,40.0,256,12946,541,285
312,39,77,312.5,40.0,261,14391,425,164
311,39,77,312.5,40.0,260,14390,576,316
310,36,77,312.5,40.0,256,13306,581,325
312,38,77,312.5,40.0,260,14030,429,169
