x,y,cell,cell_x,cell_y,opt_traj,point_id,steps_taken,extra_steps
63,23,0,65.0,20.0,10,8366,52,42
67,23,0,65.0,20.0,14,8370,56,42
62,22,0,65.0,20.0,10,8004,24,14
69,15,0,65.0,20.0,24,5484,106,82
68,21,0,65.0,20.0,17,7649,58,41
61,23,0,65.0,20.0,8,8364,49,41
69,21,0,65.0,20.0,18,7650,51,33
64,24,0,65.0,20.0,10,8728,41,31
68,17,0,65.0,20.0,21,6205,201,180
63,17,0,65.0,20.0,16,6200,111,95
71,22,1,75.0,20.0,19,8013,33,14
73,23,1,75.0,20.0,20,8376,73,53
79,16,1,75.0,20.0,33,5855,173,140
73,19,1,75.0,20.0,24,6932,65,41
71,18,1,75.0,20.0,23,6569,39,16
78,16,1,75.0,20.0,32,5854,133,101
71,20,1,75.0,20.0,21,7291,79,58
78,23,1,75.0,20.0,25,8381,105,80
76,17,1,75.0,20.0,29,6213,145,116
75,20,1,75.0,20.0,25,7295,85,60
80,18,2,85.0,20.0,32,6578,116,84
84,15,2,85.0,20.0,39,5499,121,82
86,15,2,85.0,20.0,41,5501,226,185
85,22,2,85.0,20.0,33,8027,61,28
81,24,2,85.0,20.0,27,8745,44,17
83,15,2,85.0,20.0,38,5498,166,128
89,15,2,85.0,20.0,44,5504,126,82
83,20,2,85.0,20.0,33,7303,1001,968
86,15,2,85.0,20.0,41,5501,123,82
87,19,2,85.0,20.0,38,6946,58,20
90,20,3,95.0,20.0,40,7310,85,45
93,18,3,95.0,20.0,45,6591,131,86
95,20,3,95.0,20.0,45,7315,146,101
97,19,3,95.0,20.0,48,6956,109,61
98,17,3,95.0,20.0,51,6235,162,111
99,16,3,95.0,20.0,53,5875,156,103
95,19,3,95.0,20.0,46,6954,79,33
98,24,3,95.0,20.0,44,8762,61,17
90,16,3,95.0,20.0,44,5866,143,99
94,19,3,95.0,20.0,45,6953,78,33
100,18,4,105.0,20.0,52,6598,151,99
108,22,4,105.0,20.0,56,8050,106,50
105,16,4,105.0,20.0,59,5881,173,114
105,19,4,105.0,20.0,56,6964,139,83
108,20,4,105.0,20.0,58,7328,99,41
106,23,4,105.0,20.0,53,8409,163,110
108,18,4,105.0,20.0,60,6606,167,107
100,15,4,105.0,20.0,55,5515,137,82
109,17,4,105.0,20.0,62,6246,149,87
109,20,4,105.0,20.0,59,7329,75,16
117,17,5,115.0,20.0,70,6254,173,103
113,21,5,115.0,20.0,62,7694,117,55
115,20,5,115.0,20.0,65,7335,165,100
112,19,5,115.0,20.0,63,6971,132,69
110,23,5,115.0,20.0,57,8413,964,907
117,19,5,115.0,20.0,68,6976,87,19
111,22,5,115.0,20.0,59,8053,149,90
119,23,5,115.0,20.0,66,8422,178,112
116,22,5,115.0,20.0,64,8058,141,77
113,21,5,115.0,20.0,62,7694,108,46
126,19,6,125.0,20.0,77,6985,231,154
120,15,6,125.0,20.0,75,5535,157,82
125,16,6,125.0,20.0,79,5901,179,100
129,23,6,125.0,20.0,76,8432,181,105
123,24,6,125.0,20.0,69,8787,596,527
128,15,6,125.0,20.0,83,5543,165,82
129,15,6,125.0,20.0,84,5544,167,83
122,18,6,125.0,20.0,74,6620,188,114
127,24,6,125.0,20.0,73,8791,190,117
125,19,6,125.0,20.0,76,6984,236,160
131,19,7,135.0,20.0,82,6990,238,156
139,17,7,135.0,20.0,92,6276,209,117
131,21,7,135.0,20.0,80,7712,231,151
136,18,7,135.0,20.0,88,6634,216,128
139,22,7,135.0,20.0,87,8081,382,295
131,19,7,135.0,20.0,82,6990,239,157
130,20,7,135.0,20.0,80,7350,176,96
139,15,7,135.0,20.0,94,5554,1001,907
139,23,7,135.0,20.0,86,8442,243,157
138,16,7,135.0,20.0,92,5914,231,139
146,18,8,145.0,20.0,98,6644,218,120
149,17,8,145.0,20.0,102,6286,191,89
145,16,8,145.0,20.0,99,5921,243,144
143,21,8,145.0,20.0,92,7724,217,125
143,17,8,145.0,20.0,96,6280,199,103
149,16,8,145.0,20.0,103,5925,194,91
146,18,8,145.0,20.0,98,6644,198,100
147,19,8,145.0,20.0,98,7006,251,153
143,15,8,145.0,20.0,98,5558,181,83
140,22,8,145.0,20.0,88,8082,240,152
155,21,9,155.0,20.0,104,7736,381,277
156,20,9,155.0,20.0,106,7376,205,99
155,20,9,155.0,20.0,105,7375,280,175
159,16,9,155.0,20.0,113,5935,1001,888
152,17,9,155.0,20.0,105,6289,214,109
153,21,9,155.0,20.0,102,7734,218,116
156,18,9,155.0,20.0,108,6654,287,179
154,18,9,155.0,20.0,106,6652,250,144
158,17,9,155.0,20.0,111,6295,233,122
152,17,9,155.0,20.0,105,6289,1001,896
160,20,10,165.0,20.0,110,7380,1001,891
163,15,10,165.0,20.0,118,5578,983,865
164,15,10,165.0,20.0,119,5579,1001,882
169,22,10,165.0,20.0,117,8111,227,110
168,20,10,165.0,20.0,118,7388,309,191
161,21,10,165.0,20.0,110,7742,212,102
161,22,10,165.0,20.0,109,8103,221,112
162,16,10,165.0,20.0,116,5938,213,97
167,21,10,165.0,20.0,116,7748,223,107
161,20,10,165.0,20.0,111,7381,207,96
177,16,11,175.0,20.0,131,5953,1001,870
173,21,11,175.0,20.0,122,7754,247,125
179,18,11,175.0,20.0,131,6677,1001,870
170,19,11,175.0,20.0,121,7029,1001,880
177,20,11,175.0,20.0,127,7397,385,258
174,21,11,175.0,20.0,123,7755,393,270
173,23,11,175.0,20.0,120,8476,230,110
170,22,11,175.0,20.0,118,8112,899,781
171,20,11,175.0,20.0,121,7391,357,236
173,15,11,175.0,20.0,128,5588,1001,873
189,16,12,185.0,20.0,143,5965,719,576
181,16,12,185.0,20.0,135,5957,727,592
180,22,12,185.0,20.0,128,8122,404,276
189,24,12,185.0,20.0,135,8853,294,159
180,15,12,185.0,20.0,135,5595,1001,866
183,17,12,185.0,20.0,136,6320,742,606
183,22,12,185.0,20.0,131,8125,415,284
187,18,12,185.0,20.0,139,6685,749,610
189,24,12,185.0,20.0,135,8853,256,121
183,24,12,185.0,20.0,129,8847,239,110
197,24,13,195.0,20.0,143,8861,252,109
198,22,13,195.0,20.0,146,8140,335,189
197,22,13,195.0,20.0,145,8139,301,156
199,22,13,195.0,20.0,147,8141,532,385
190,19,13,195.0,20.0,141,7049,766,625
190,23,13,195.0,20.0,137,8493,301,164
195,19,13,195.0,20.0,146,7054,752,606
199,16,13,195.0,20.0,153,5975,709,556
194,22,13,195.0,20.0,142,8136,279,137
191,19,13,195.0,20.0,142,7050,748,606
202,17,14,205.0,20.0,155,6339,721,566
200,22,14,205.0,20.0,148,8142,334,186
209,17,14,205.0,20.0,162,6346,716,554
202,24,14,205.0,20.0,148,8866,257,109
200,17,14,205.0,20.0,153,6337,726,573
203,23,14,205.0,20.0,150,8506,338,188
205,18,14,205.0,20.0,157,6703,727,570
201,16,14,205.0,20.0,155,5977,707,552
202,15,14,205.0,20.0,157,5617,707,550
208,24,14,205.0,20.0,154,8872,264,110
210,17,15,215.0,20.0,163,6347,714,551
219,24,15,215.0,20.0,165,8883,315,150
210,18,15,215.0,20.0,162,6708,732,570
212,18,15,215.0,20.0,164,6710,715,551
214,23,15,215.0,20.0,161,8517,319,158
217,15,15,215.0,20.0,172,5632,700,528
218,15,15,215.0,20.0,173,5633,697,524
219,17,15,215.0,20.0,172,6356,716,544
212,21,15,215.0,20.0,161,7793,283,122
210,22,15,215.0,20.0,158,8152,348,190
222,17,16,225.0,20.0,175,6359,699,524
224,21,16,225.0,20.0,173,7805,312,139
224,21,16,225.0,20.0,173,7805,1001,828
224,21,16,225.0,20.0,173,7805,728,555
225,21,16,225.0,20.0,174,7806,1001,827
223,21,16,225.0,20.0,172,7804,329,157
222,18,16,225.0,20.0,174,6720,703,529
228,23,16,225.0,20.0,175,8531,285,110
220,18,16,225.0,20.0,172,6718,709,537
222,21,16,225.0,20.0,171,7803,1001,830
239,23,17,235.0,20.0,186,8542,472,286
230,17,17,235.0,20.0,183,6367,403,220
233,17,17,235.0,20.0,186,6370,421,235
236,16,17,235.0,20.0,190,6012,413,223
232,20,17,235.0,20.0,182,7452,417,235
234,24,17,235.0,20.0,180,8898,483,303
233,22,17,235.0,20.0,181,8175,456,275
231,21,17,235.0,20.0,180,7812,436,256
230,16,17,235.0,20.0,184,6006,404,220
233,19,17,235.0,20.0,184,7092,439,255
243,22,18,245.0,20.0,191,8185,444,253
247,16,18,245.0,20.0,201,6023,408,207
249,16,18,245.0,20.0,203,6025,436,233
245,21,18,245.0,20.0,194,7826,436,242
245,24,18,245.0,20.0,191,8909,1001,810
244,23,18,245.0,20.0,191,8547,485,294
249,18,18,245.0,20.0,201,6747,404,203
242,19,18,245.0,20.0,193,7101,389,196
240,24,18,245.0,20.0,186,8904,489,303
246,22,18,245.0,20.0,194,8188,437,243
255,23,19,255.0,20.0,202,8558,692,490
252,20,19,255.0,20.0,202,7472,406,204
253,15,19,255.0,20.0,208,5668,440,232
254,20,19,255.0,20.0,204,7474,431,227
250,23,19,255.0,20.0,197,8553,421,224
252,15,19,255.0,20.0,207,5667,437,230
251,19,19,255.0,20.0,202,7110,380,178
259,20,19,255.0,20.0,209,7479,395,186
258,19,19,255.0,20.0,209,7117,373,164
257,20,19,255.0,20.0,207,7477,393,186
260,18,20,265.0,20.0,212,6758,378,166
269,23,20,265.0,20.0,216,8572,407,191
265,17,20,265.0,20.0,218,6402,388,170
269,18,20,265.0,20.0,221,6767,389,168
268,16,20,265.0,20.0,222,6044,383,161
265,17,20,265.0,20.0,218,6402,491,273
267,21,20,265.0,20.0,216,7848,388,172
267,22,20,265.0,20.0,215,8209,403,188
269,23,20,265.0,20.0,216,8572,386,170
261,23,20,265.0,20.0,208,8564,365,157
274,21,21,275.0,20.0,223,7855,415,192
278,23,21,275.0,20.0,225,8581,520,295
275,19,21,275.0,20.0,226,7134,404,178
272,18,21,275.0,20.0,224,6770,395,171
277,21,21,275.0,20.0,226,7858,400,174
275,17,21,275.0,20.0,228,6412,403,175
276,23,21,275.0,20.0,223,8579,414,191
271,24,21,275.0,20.0,217,8935,399,182
279,22,21,275.0,20.0,227,8221,451,224
271,18,21,275.0,20.0,223,6769,416,193
288,21,22,285.0,20.0,237,7869,642,405
285,22,22,285.0,20.0,233,8227,403,170
281,16,22,285.0,20.0,235,6057,517,282
288,23,22,285.0,20.0,235,8591,428,193
285,23,22,285.0,20.0,232,8588,410,178
287,20,22,285.0,20.0,237,7507,493,256
285,16,22,285.0,20.0,239,6061,652,413
283,19,22,285.0,20.0,234,7142,399,165
289,24,22,285.0,20.0,235,8953,478,243
285,24,22,285.0,20.0,231,8949,437,206
295,18,23,295.0,20.0,247,6793,412,165
295,18,23,295.0,20.0,247,6793,581,334
292,18,23,295.0,20.0,244,6790,407,163
294,15,23,295.0,20.0,249,5709,551,302
298,23,23,295.0,20.0,245,8601,562,317
294,23,23,295.0,20.0,241,8597,424,183
295,20,23,295.0,20.0,245,7515,408,163
292,23,23,295.0,20.0,239,8595,580,341
294,24,23,295.0,20.0,240,8958,554,314
295,15,23,295.0,20.0,250,5710,552,302
300,17,24,305.0,20.0,253,6437,581,328
307,22,24,305.0,20.0,255,8249,634,379
307,19,24,305.0,20.0,258,7166,483,225
303,19,24,305.0,20.0,254,7162,582,328
305,20,24,305.0,20.0,255,7525,446,191
302,19,24,305.0,20.0,253,7161,430,177
303,24,24,305.0,20.0,249,8967,432,183
306,22,24,305.0,20.0,254,8248,471,217
305,24,24,305.0,20.0,251,8969,417,166
300,20,24,305.0,20.0,250,7520,500,250
310,17,25,312.5,20.0,263,6447,511,248
313,20,25,312.5,20.0,263,7533,625,362
314,16,25,312.5,20.0,268,6090,579,311
312,24,25,312.5,20.0,258,8976,627,369
313,19,25,312.5,20.0,264,7172,598,334
313,21,25,312.5,20.0,262,7894,462,200
312,17,25,312.5,20.0,265,6449,1001,736
310,17,25,312.5,20.0,263,6447,608,345
310,17,25,312.5,20.0,263,6447,625,362
313,22,25,312.5,20.0,261,8255,437,176
65,29,26,65.0,30.0,6,10534,34,28
60,32,26,65.0,30.0,2,11612,3,1
69,28,26,65.0,30.0,11,10177,39,28
68,26,26,65.0,30.0,12,9454,40,28
68,29,26,65.0,30.0,9,10537,26,17
64,26,26,65.0,30.0,8,9450,45,37
61,33,26,65.0,30.0,4,11974,7,3
61,34,26,65.0,30.0,5,12335,46,41
61,26,26,65.0,30.0,5,9447,35,30
66,30,26,65.0,30.0,6,10896,9,3
77,30,27,75.0,30.0,17,10907,46,29
73,26,27,75.0,30.0,17,9459,46,29
72,26,27,75.0,30.0,16,9458,47,31
75,31,27,75.0,30.0,16,11266,29,13
72,27,27,75.0,30.0,15,9819,57,42
70,30,27,75.0,30.0,10,10900,63,53
79,30,27,75.0,30.0,19,10909,61,42
73,29,27,75.0,30.0,14,10542,41,27
73,25,27,75.0,30.0,18,9098,32,14
75,30,27,75.0,30.0,15,10905,41,26
89,25,28,85.0,30.0,34,9114,326,292
85,27,28,85.0,30.0,28,9832,59,31
84,34,28,85.0,30.0,28,12358,68,40
82,32,28,85.0,30.0,24,11634,251,227
88,30,28,85.0,30.0,28,10918,1001,973
86,34,28,85.0,30.0,30,12360,62,32
80,27,28,85.0,30.0,23,9827,50,27
81,34,28,85.0,30.0,25,12355,77,52
82,28,28,85.0,30.0,24,10190,53,29
82,29,28,85.0,30.0,23,10551,99,76
92,31,29,95.0,30.0,33,11283,202,169
96,32,29,95.0,30.0,38,11648,184,146
94,27,29,95.0,30.0,37,9841,116,79
91,30,29,95.0,30.0,31,10921,149,118
92,26,29,95.0,30.0,36,9478,99,63
95,30,29,95.0,30.0,35,10925,106,71
93,28,29,95.0,30.0,35,10201,71,36
94,32,29,95.0,30.0,36,11646,93,57
95,28,29,95.0,30.0,37,10203,73,36
93,33,29,95.0,30.0,36,12006,117,81
105,29,30,105.0,30.0,46,10574,953,907
100,28,30,105.0,30.0,42,10208,259,217
104,32,30,105.0,30.0,46,11656,314,268
104,29,30,105.0,30.0,45,10573,103,58
107,32,30,105.0,30.0,49,11659,960,911
105,34,30,105.0,30.0,49,12379,102,53
103,31,30,105.0,30.0,44,11294,963,919
104,28,30,105.0,30.0,46,10212,938,892
101,32,30,105.0,30.0,43,11653,140,97
104,32,30,105.0,30.0,46,11656,280,234
114,27,31,115.0,30.0,57,9861,905,848
115,30,31,115.0,30.0,55,10945,85,30
116,34,31,115.0,30.0,60,12390,161,101
115,27,31,115.0,30.0,58,9862,886,828
114,32,31,115.0,30.0,56,11666,869,813
118,33,31,115.0,30.0,61,12031,115,54
117,25,31,115.0,30.0,62,9142,210,148
112,29,31,115.0,30.0,53,10581,140,87
113,27,31,115.0,30.0,56,9860,155,99
116,26,31,115.0,30.0,60,9502,110,50
123,25,32,125.0,30.0,68,9148,220,152
129,26,32,125.0,30.0,73,9515,184,111
127,25,32,125.0,30.0,72,9152,227,155
128,26,32,125.0,30.0,72,9514,189,117
129,28,32,125.0,30.0,71,10237,882,811
125,34,32,125.0,30.0,69,12399,849,780
127,28,32,125.0,30.0,69,10235,879,810
123,34,32,125.0,30.0,67,12397,851,784
125,25,32,125.0,30.0,70,9150,239,169
128,32,32,125.0,30.0,70,11680,870,800
135,29,33,135.0,30.0,76,10604,901,825
132,34,33,135.0,30.0,76,12406,877,801
134,26,33,135.0,30.0,78,9520,191,113
138,28,33,135.0,30.0,80,10246,908,828
133,31,33,135.0,30.0,74,11324,862,788
135,26,33,135.0,30.0,79,9521,204,125
131,28,33,135.0,30.0,73,10239,893,820
136,29,33,135.0,30.0,77,10605,880,803
135,26,33,135.0,30.0,79,9521,278,199
131,31,33,135.0,30.0,72,11322,876,804
145,34,34,145.0,30.0,89,12419,799,710
143,25,34,145.0,30.0,88,9168,247,159
142,29,34,145.0,30.0,83,10611,815,732
147,32,34,145.0,30.0,89,11699,824,735
143,34,34,145.0,30.0,87,12417,801,714
147,33,34,145.0,30.0,90,12060,816,726
142,31,34,145.0,30.0,83,11333,826,743
142,28,34,145.0,30.0,84,10250,856,772
142,33,34,145.0,30.0,85,12055,830,745
141,31,34,145.0,30.0,82,11332,826,744
150,34,35,155.0,30.0,94,12424,821,727
154,28,35,155.0,30.0,96,10262,1001,905
157,30,35,155.0,30.0,97,10987,848,751
151,32,35,155.0,30.0,93,11703,815,722
151,25,35,155.0,30.0,96,9176,211,115
155,34,35,155.0,30.0,99,12429,814,715
151,32,35,155.0,30.0,93,11703,818,725
156,27,35,155.0,30.0,99,9903,983,884
156,26,35,155.0,30.0,100,9542,226,126
150,34,35,155.0,30.0,94,12424,845,751
165,25,36,165.0,30.0,110,9190,347,237
169,27,36,165.0,30.0,112,9916,235,123
160,33,36,165.0,30.0,103,12073,816,713
166,26,36,165.0,30.0,110,9552,244,134
166,28,36,165.0,30.0,108,10274,286,178
167,34,36,165.0,30.0,111,12441,828,717
164,30,36,165.0,30.0,104,10994,1001,897
163,31,36,165.0,30.0,104,11354,862,758
167,30,36,165.0,30.0,107,10997,866,759
168,28,36,165.0,30.0,110,10276,1001,891
178,28,37,175.0,30.0,120,10286,241,121
178,33,37,175.0,30.0,121,12091,246,125
173,25,37,175.0,30.0,118,9198,291,173
172,30,37,175.0,30.0,112,11002,878,766
178,25,37,175.0,30.0,123,9203,302,179
173,32,37,175.0,30.0,115,11725,751,636
175,27,37,175.0,30.0,118,9922,235,117
174,32,37,175.0,30.0,116,11726,750,634
177,30,37,175.0,30.0,117,11007,745,628
172,31,37,175.0,30.0,113,11363,885,772
184,26,38,185.0,30.0,128,9570,342,214
184,31,38,185.0,30.0,125,11375,277,152
189,27,38,185.0,30.0,132,9936,290,158
183,26,38,185.0,30.0,127,9569,652,525
182,27,38,185.0,30.0,125,9929,282,157
186,25,38,185.0,30.0,131,9211,247,116
189,28,38,185.0,30.0,131,10297,481,350
188,26,38,185.0,30.0,132,9574,355,223
186,28,38,185.0,30.0,128,10294,252,124
182,33,38,185.0,30.0,125,12095,262,137
192,27,39,195.0,30.0,135,9939,329,194
198,34,39,195.0,30.0,142,12472,286,144
195,25,39,195.0,30.0,140,9220,252,112
199,31,39,195.0,30.0,140,11390,362,222
199,33,39,195.0,30.0,142,12112,272,130
197,30,39,195.0,30.0,137,11027,277,140
193,32,39,195.0,30.0,135,11745,348,213
191,33,39,195.0,30.0,134,12104,266,132
191,28,39,195.0,30.0,133,10299,408,275
191,26,39,195.0,30.0,135,9577,465,330
208,34,40,205.0,30.0,152,12482,280,128
208,32,40,205.0,30.0,150,11760,297,147
202,26,40,205.0,30.0,146,9588,337,191
207,28,40,205.0,30.0,149,10315,1001,852
209,30,40,205.0,30.0,149,11039,332,183
201,32,40,205.0,30.0,143,11753,323,180
205,32,40,205.0,30.0,147,11757,1001,854
206,28,40,205.0,30.0,148,10314,387,239
202,33,40,205.0,30.0,145,12115,275,130
200,29,40,205.0,30.0,141,10669,262,121
218,26,41,215.0,30.0,162,9604,1001,839
213,32,41,215.0,30.0,155,11765,318,163
214,31,41,215.0,30.0,155,11405,329,174
210,33,41,215.0,30.0,153,12123,337,184
216,26,41,215.0,30.0,160,9602,336,176
218,33,41,215.0,30.0,161,12131,319,158
215,33,41,215.0,30.0,158,12128,286,128
216,28,41,215.0,30.0,158,10324,343,185
218,27,41,215.0,30.0,161,9965,370,209
212,31,41,215.0,30.0,153,11403,791,638
221,32,42,225.0,30.0,163,11773,1001,838
228,31,42,225.0,30.0,169,11419,303,134
228,27,42,225.0,30.0,171,9975,372,201
227,32,42,225.0,30.0,169,11779,372,203
222,34,42,225.0,30.0,166,12496,353,187
227,31,42,225.0,30.0,168,11418,438,270
222,33,42,225.0,30.0,165,12135,341,176
226,33,42,225.0,30.0,169,12139,1001,832
225,34,42,225.0,30.0,169,12499,1001,832
223,28,42,225.0,30.0,165,10331,1001,836
230,27,43,235.0,30.0,173,9977,364,191
237,34,43,235.0,30.0,181,12511,451,270
235,32,43,235.0,30.0,177,11787,465,288
230,26,43,235.0,30.0,174,9616,1001,827
236,29,43,235.0,30.0,177,10705,459,282
239,31,43,235.0,30.0,180,11430,490,310
231,28,43,235.0,30.0,173,10339,465,292
239,31,43,235.0,30.0,180,11430,454,274
238,30,43,235.0,30.0,178,11068,469,291
235,33,43,235.0,30.0,178,12148,448,270
246,26,44,245.0,30.0,190,9632,524,334
243,26,44,245.0,30.0,187,9629,450,263
245,29,44,245.0,30.0,186,10714,471,285
246,25,44,245.0,30.0,191,9271,480,289
243,34,44,245.0,30.0,187,12517,496,309
245,28,44,245.0,30.0,187,10353,468,281
243,34,44,245.0,30.0,187,12517,457,270
240,30,44,245.0,30.0,180,11070,454,274
243,27,44,245.0,30.0,186,9990,485,299
248,26,44,245.0,30.0,192,9634,504,312
259,29,45,255.0,30.0,200,10728,363,163
250,30,45,255.0,30.0,190,11080,503,313
254,29,45,255.0,30.0,195,10723,1001,806
257,25,45,255.0,30.0,202,9282,1001,799
254,30,45,255.0,30.0,194,11084,532,338
252,26,45,255.0,30.0,196,9638,561,365
254,28,45,255.0,30.0,196,10362,1001,805
258,33,45,255.0,30.0,201,12171,367,166
254,31,45,255.0,30.0,195,11445,505,310
256,32,45,255.0,30.0,198,11808,349,151
260,31,46,265.0,30.0,201,11451,397,196
266,34,46,265.0,30.0,210,12540,383,173
268,28,46,265.0,30.0,210,10376,378,168
269,33,46,265.0,30.0,212,12182,482,270
266,30,46,265.0,30.0,206,11096,361,155
264,29,46,265.0,30.0,205,10733,362,157
267,34,46,265.0,30.0,211,12541,391,180
262,34,46,265.0,30.0,206,12536,381,175
268,28,46,265.0,30.0,210,10376,416,206
269,29,46,265.0,30.0,210,10738,365,155
278,30,47,275.0,30.0,218,11108,405,187
278,33,47,275.0,30.0,221,12191,493,272
275,28,47,275.0,30.0,217,10383,380,163
277,31,47,275.0,30.0,218,11468,600,382
276,32,47,275.0,30.0,218,11828,399,181
277,29,47,275.0,30.0,218,10746,373,155
272,27,47,275.0,30.0,215,10019,382,167
279,27,47,275.0,30.0,222,10026,377,155
275,25,47,275.0,30.0,220,9300,399,179
273,33,47,275.0,30.0,216,12186,393,177
286,34,48,285.0,30.0,230,12560,428,198
284,29,48,285.0,30.0,225,10753,381,156
282,28,48,285.0,30.0,224,10390,432,208
288,29,48,285.0,30.0,229,10757,420,191
281,25,48,285.0,30.0,226,9306,416,190
287,33,48,285.0,30.0,230,12200,500,270
283,28,48,285.0,30.0,225,10391,427,202
288,31,48,285.0,30.0,229,11479,639,410
289,29,48,285.0,30.0,230,10758,646,416
283,29,48,285.0,30.0,224,10752,1001,777
291,25,49,295.0,30.0,236,9316,428,192
295,29,49,295.0,30.0,236,10764,447,211
298,34,49,295.0,30.0,242,12572,572,330
290,33,49,295.0,30.0,233,12203,573,340
291,34,49,295.0,30.0,235,12565,505,270
292,26,49,295.0,30.0,236,9678,412,176
299,32,49,295.0,30.0,241,11851,601,360
298,26,49,295.0,30.0,242,9684,409,167
295,27,49,295.0,30.0,238,10042,546,308
291,31,49,295.0,30.0,232,11482,570,338
306,25,50,305.0,30.0,251,9331,599,348
308,27,50,305.0,30.0,251,10055,433,182
308,30,50,305.0,30.0,248,11138,604,356
302,26,50,305.0,30.0,246,9688,563,317
302,30,50,305.0,30.0,242,11132,454,212
304,34,50,305.0,30.0,248,12578,551,303
301,27,50,305.0,30.0,244,10048,424,180
301,26,50,305.0,30.0,245,9687,466,221
307,26,50,305.0,30.0,251,9693,434,183
300,30,50,305.0,30.0,240,11130,424,184
310,34,51,312.5,30.0,254,12584,567,313
311,33,51,312.5,30.0,254,12224,1001,747
313,28,51,312.5,30.0,255,10421,499,244
313,34,51,312.5,30.0,257,12587,559,302
313,26,51,312.5,30.0,257,9699,437,180
314,30,51,312.5,30.0,254,11144,1001,747
314,33,51,312.5,30.0,257,12227,620,363
311,33,51,312.5,30.0,254,12224,626,372
312,34,51,312.5,30.0,256,12586,613,357
312,33,51,312.5,30.0,255,12225,664,409
61,40,52,65.0,40.0,11,14501,75,64
62,39,52,65.0,40.0,11,14141,64,53
60,38,52,65.0,40.0,8,13778,49,41
69,42,52,65.0,40.0,21,15231,100,79
62,41,52,65.0,40.0,13,14863,82,69
67,43,52,65.0,40.0,20,15590,61,41
61,42,52,65.0,40.0,13,15223,64,51
63,42,52,65.0,40.0,15,15225,71,56
69,40,52,65.0,40.0,19,14509,70,51
62,41,52,65.0,40.0,13,14863,68,55
74,35,53,75.0,40.0,19,12709,34,15
74,43,53,75.0,40.0,27,15597,68,41
78,40,53,75.0,40.0,28,14518,49,21
75,44,53,75.0,40.0,29,15959,73,44
76,35,53,75.0,40.0,21,12711,25,4
79,35,53,75.0,40.0,24,12714,54,30
76,35,53,75.0,40.0,21,12711,61,40
70,39,53,75.0,40.0,19,14149,68,49
73,40,53,75.0,40.0,23,14513,363,340
74,36,53,75.0,40.0,20,13070,21,1
89,42,54,85.0,40.0,41,15251,110,69
82,39,54,85.0,40.0,31,14161,112,81
88,35,54,85.0,40.0,33,12723,37,4
84,40,54,85.0,40.0,34,14524,86,52
85,40,54,85.0,40.0,35,14525,143,108
88,41,54,85.0,40.0,39,14889,110,71
86,40,54,85.0,40.0,36,14526,133,97
86,39,54,85.0,40.0,35,14165,162,127
82,38,54,85.0,40.0,30,13800,107,77
82,37,54,85.0,40.0,29,13439,91,62
92,35,55,95.0,40.0,37,12727,49,12
90,36,55,95.0,40.0,36,13086,46,10
96,40,55,95.0,40.0,46,14536,100,54
91,38,55,95.0,40.0,39,13809,41,2
97,43,55,95.0,40.0,50,15620,136,86
96,40,55,95.0,40.0,46,14536,185,139
92,43,55,95.0,40.0,45,15615,138,93
95,37,55,95.0,40.0,42,13452,282,240
97,38,55,95.0,40.0,45,13815,110,65
98,35,55,95.0,40.0,43,12733,49,6
105,43,56,105.0,40.0,58,15628,123,65
105,42,56,105.0,40.0,57,15267,161,104
101,42,56,105.0,40.0,53,15263,170,117
104,39,56,105.0,40.0,53,14183,57,4
107,43,56,105.0,40.0,60,15630,977,917
109,36,56,105.0,40.0,55,13105,114,59
108,35,56,105.0,40.0,53,12743,154,101
102,40,56,105.0,40.0,52,14542,108,56
102,37,56,105.0,40.0,49,13459,250,201
107,39,56,105.0,40.0,56,14186,1000,944
113,37,57,115.0,40.0,60,13470,109,49
113,35,57,115.0,40.0,58,12748,63,5
114,42,57,115.0,40.0,66,15276,142,76
116,36,57,115.0,40.0,62,13112,68,6
117,37,57,115.0,40.0,64,13474,892,828
119,41,57,115.0,40.0,70,14920,907,837
111,35,57,115.0,40.0,56,12746,64,8
115,43,57,115.0,40.0,68,15638,133,65
110,35,57,115.0,40.0,55,12745,63,8
111,37,57,115.0,40.0,58,13468,183,125
125,37,58,125.0,40.0,72,13482,881,809
127,38,58,125.0,40.0,75,13845,912,837
127,37,58,125.0,40.0,74,13484,844,770
127,36,58,125.0,40.0,73,13123,884,811
126,40,58,125.0,40.0,76,14566,900,824
128,36,58,125.0,40.0,74,13124,865,791
120,38,58,125.0,40.0,68,13838,120,52
128,38,58,125.0,40.0,76,13846,916,840
128,38,58,125.0,40.0,76,13846,857,781
127,42,58,125.0,40.0,79,15289,908,829
130,44,59,135.0,40.0,84,16014,909,825
131,37,59,135.0,40.0,78,13488,846,768
136,43,59,135.0,40.0,89,15659,1001,912
137,40,59,135.0,40.0,87,14577,831,744
133,41,59,135.0,40.0,84,14934,851,767
139,40,59,135.0,40.0,89,14579,834,745
137,37,59,135.0,40.0,84,13494,842,758
130,37,59,135.0,40.0,77,13487,842,765
132,40,59,135.0,40.0,82,14572,922,840
130,39,59,135.0,40.0,79,14209,858,779
147,42,60,145.0,40.0,99,15309,859,760
147,41,60,145.0,40.0,98,14948,844,746
142,42,60,145.0,40.0,94,15304,842,748
147,41,60,145.0,40.0,98,14948,836,738
144,37,60,145.0,40.0,91,13501,825,734
147,40,60,145.0,40.0,97,14587,838,741
141,41,60,145.0,40.0,92,14942,836,744
146,35,60,145.0,40.0,91,12781,825,734
146,44,60,145.0,40.0,100,16030,851,751
140,37,60,145.0,40.0,87,13497,836,749
154,35,61,155.0,40.0,99,12789,789,690
153,44,61,155.0,40.0,107,16037,855,748
157,44,61,155.0,40.0,111,16041,847,736
157,40,61,155.0,40.0,107,14597,832,725
150,36,61,155.0,40.0,96,13146,815,719
155,43,61,155.0,40.0,108,15678,860,752
152,40,61,155.0,40.0,102,14592,850,748
154,42,61,155.0,40.0,106,15316,866,760
155,40,61,155.0,40.0,105,14595,849,744
150,36,61,155.0,40.0,96,13146,825,729
168,43,62,165.0,40.0,121,15691,767,646
168,40,62,165.0,40.0,118,14608,780,662
166,35,62,165.0,40.0,111,12801,807,696
169,40,62,165.0,40.0,119,14609,816,697
168,36,62,165.0,40.0,114,13164,818,704
161,40,62,165.0,40.0,111,14601,788,677
167,43,62,165.0,40.0,120,15690,780,660
169,41,62,165.0,40.0,120,14970,764,644
169,38,62,165.0,40.0,117,13887,785,668
168,42,62,165.0,40.0,120,15330,766,646
173,37,63,175.0,40.0,120,13530,776,656
171,38,63,175.0,40.0,119,13889,782,663
170,37,63,175.0,40.0,117,13527,760,643
171,38,63,175.0,40.0,119,13889,762,643
177,43,63,175.0,40.0,130,15700,772,642
170,40,63,175.0,40.0,120,14610,762,642
175,41,63,175.0,40.0,126,14976,768,642
170,40,63,175.0,40.0,120,14610,762,642
179,39,63,175.0,40.0,128,14258,265,137
178,39,63,175.0,40.0,127,14257,777,650
185,37,64,185.0,40.0,132,13542,288,156
185,41,64,185.0,40.0,136,14986,269,133
185,38,64,185.0,40.0,133,13903,259,126
185,37,64,185.0,40.0,132,13542,288,156
186,39,64,185.0,40.0,135,14265,291,156
182,44,64,185.0,40.0,136,16066,804,668
186,39,64,185.0,40.0,135,14265,261,126
186,41,64,185.0,40.0,137,14987,271,134
181,39,64,185.0,40.0,130,14260,791,661
181,39,64,185.0,40.0,130,14260,256,126
198,40,65,195.0,40.0,148,14638,283,135
193,38,65,195.0,40.0,141,13911,287,146
194,35,65,195.0,40.0,139,12829,265,126
199,38,65,195.0,40.0,147,13917,314,167
197,35,65,195.0,40.0,142,12832,270,128
190,42,65,195.0,40.0,142,15352,269,127
194,39,65,195.0,40.0,143,14273,290,147
199,36,65,195.0,40.0,145,13195,296,151
197,37,65,195.0,40.0,144,13554,350,206
193,40,65,195.0,40.0,143,14633,274,131
205,41,66,205.0,40.0,156,15006,339,183
200,41,66,205.0,40.0,151,15001,290,139
200,35,66,205.0,40.0,145,12835,308,163
202,37,66,205.0,40.0,149,13559,1001,852
204,41,66,205.0,40.0,155,15005,383,228
203,38,66,205.0,40.0,151,13921,286,135
202,43,66,205.0,40.0,155,15725,298,143
201,41,66,205.0,40.0,152,15002,291,139
205,43,66,205.0,40.0,158,15728,287,129
208,35,66,205.0,40.0,153,12843,313,160
218,36,67,215.0,40.0,164,13214,297,133
211,41,67,215.0,40.0,162,15012,402,240
215,36,67,215.0,40.0,161,13211,293,132
211,37,67,215.0,40.0,158,13568,316,158
214,36,67,215.0,40.0,160,13210,1001,841
210,44,67,215.0,40.0,164,16094,313,149
218,35,67,215.0,40.0,163,12853,298,135
214,43,67,215.0,40.0,167,15737,303,136
215,43,67,215.0,40.0,168,15738,366,198
212,38,67,215.0,40.0,160,13930,1001,841
220,42,68,225.0,40.0,172,15382,343,171
220,37,68,225.0,40.0,167,13577,298,131
229,44,68,225.0,40.0,183,16113,351,168
229,37,68,225.0,40.0,176,13586,305,129
229,41,68,225.0,40.0,180,15030,379,199
222,42,68,225.0,40.0,174,15384,349,175
220,36,68,225.0,40.0,166,13216,297,131
225,39,68,225.0,40.0,174,14304,1001,827
229,44,68,225.0,40.0,183,16113,336,153
229,43,68,225.0,40.0,182,15752,309,127
235,35,69,235.0,40.0,180,12870,461,281
237,44,69,235.0,40.0,191,16121,369,178
234,36,69,235.0,40.0,180,13230,1001,821
233,44,69,235.0,40.0,187,16117,333,146
234,43,69,235.0,40.0,187,15757,315,128
239,39,69,235.0,40.0,188,14318,1001,813
238,40,69,235.0,40.0,188,14678,359,171
239,38,69,235.0,40.0,187,13957,1001,814
235,44,69,235.0,40.0,189,16119,347,158
233,35,69,235.0,40.0,178,12868,465,287
241,42,70,245.0,40.0,193,15403,325,132
241,36,70,245.0,40.0,187,13237,390,203
248,43,70,245.0,40.0,201,15771,329,128
248,39,70,245.0,40.0,197,14327,368,171
246,41,70,245.0,40.0,197,15047,363,166
241,35,70,245.0,40.0,186,12876,460,274
246,40,70,245.0,40.0,196,14686,369,173
247,35,70,245.0,40.0,192,12882,479,287
249,39,70,245.0,40.0,198,14328,1001,803
245,44,70,245.0,40.0,199,16129,365,166
256,39,71,255.0,40.0,205,14335,341,136
257,36,71,255.0,40.0,203,13253,346,143
253,35,71,255.0,40.0,198,12888,488,290
250,36,71,255.0,40.0,196,13246,598,402
254,35,71,255.0,40.0,199,12889,475,276
253,40,71,255.0,40.0,203,14693,396,193
251,39,71,255.0,40.0,200,14330,1001,801
251,36,71,255.0,40.0,197,13247,473,276
255,36,71,255.0,40.0,201,13251,509,308
259,35,71,255.0,40.0,204,12894,369,165
268,37,72,265.0,40.0,215,13625,376,161
260,37,72,265.0,40.0,207,13617,392,185
260,39,72,265.0,40.0,209,14339,385,176
268,36,72,265.0,40.0,214,13264,373,159
266,41,72,265.0,40.0,217,15067,418,201
263,42,72,265.0,40.0,215,15425,364,149
267,40,72,265.0,40.0,217,14707,466,249
264,43,72,265.0,40.0,217,15787,346,129
265,39,72,265.0,40.0,214,14344,390,176
260,36,72,265.0,40.0,206,13256,368,162
272,44,73,275.0,40.0,226,16156,369,143
279,39,73,275.0,40.0,228,14358,1001,773
279,43,73,275.0,40.0,232,15802,361,129
272,42,73,275.0,40.0,224,15434,422,198
278,39,73,275.0,40.0,227,14357,412,185
276,39,73,275.0,40.0,225,14355,380,155
277,39,73,275.0,40.0,226,14356,393,167
273,38,73,275.0,40.0,221,13991,630,409
271,43,73,275.0,40.0,224,15794,352,128
270,44,73,275.0,40.0,224,16154,367,143
287,42,74,285.0,40.0,239,15449,585,346
282,44,74,285.0,40.0,236,16166,1001,765
286,43,74,285.0,40.0,239,15809,587,348
284,44,74,285.0,40.0,238,16168,590,352
285,40,74,285.0,40.0,235,14725,613,378
288,40,74,285.0,40.0,238,14728,618,380
289,41,74,285.0,40.0,240,15090,623,383
289,37,74,285.0,40.0,236,13646,378,142
288,41,74,285.0,40.0,239,15089,607,368
288,44,74,285.0,40.0,242,16172,609,367
296,37,75,295.0,40.0,243,13653,414,171
293,38,75,295.0,40.0,241,14011,392,151
293,44,75,295.0,40.0,247,16177,517,270
295,36,75,295.0,40.0,241,13291,384,143
295,40,75,295.0,40.0,245,14735,425,180
298,35,75,295.0,40.0,243,12933,519,276
290,35,75,295.0,40.0,235,12925,406,171
297,37,75,295.0,40.0,244,13654,461,217
299,37,75,295.0,40.0,246,13656,559,313
297,40,75,295.0,40.0,247,14737,520,273
308,36,76,305.0,40.0,254,13304,546,292
302,41,76,305.0,40.0,253,15103,535,282
306,43,76,305.0,40.0,259,15829,534,275
309,36,76,305.0,40.0,255,13305,464,209
304,38,76,305.0,40.0,252,14022,426,174
304,43,76,305.0,40.0,257,15827,561,304
307,37,76,305.0,40.0,254,13664,547,293
302,40,76,305.0,40.0,252,14742,524,272
309,42,76,305.0,40.0,261,15471,550,289
306,43,76,305.0,40.0,259,15829,541,282
314,42,77,312.5,40.0,266,15476,558,292
313,39,77,312.5,40.0,262,14392,595,333
311,42,77,312.5,40.0,263,15473,552,289
313,40,77,312.5,40.0,263,14753,578,315
312,43,77,312.5,40.0,265,15835,557,292
310,41,77,312.5,40.0,261,15111,573,312
311,44,77,312.5,40.0,265,16195,550,285
313,39,77,312.5,40.0,262,14392,589,327
313,36,77,312.5,40.0,259,13309,467,208
312,41,77,312.5,40.0,263,15113,567,304
