x,y,cell,cell_x,cell_y,opt_traj,point_id,steps_taken,extra_steps
63,20,0,65.0,20.0,13,7283,31,18
66,17,0,65.0,20.0,19,6203,34,15
64,21,0,65.0,20.0,13,7645,40,27
61,18,0,65.0,20.0,13,6559,194,181
67,22,0,65.0,20.0,15,8009,36,21
69,23,0,65.0,20.0,16,8372,36,20
67,18,0,65.0,20.0,19,6565,53,34
67,20,0,65.0,20.0,17,7287,34,17
65,23,0,65.0,20.0,12,8368,164,152
65,15,0,65.0,20.0,20,5480,102,82
79,22,1,75.0,20.0,27,8021,65,38
71,19,1,75.0,20.0,22,6930,53,31
70,24,1,75.0,20.0,16,8734,56,40
76,16,1,75.0,20.0,30,5852,76,46
72,22,1,75.0,20.0,20,8014,43,23
78,16,1,75.0,20.0,32,5854,58,26
77,15,1,75.0,20.0,32,5492,59,27
77,22,1,75.0,20.0,25,8019,60,35
79,24,1,75.0,20.0,25,8743,61,36
77,19,1,75.0,20.0,28,6936,56,28
83,21,2,85.0,20.0,32,7664,69,37
85,17,2,85.0,20.0,38,6222,57,19
85,21,2,85.0,20.0,34,7666,1001,967
87,21,2,85.0,20.0,36,7668,93,57
81,23,2,85.0,20.0,28,8384,66,38
88,22,2,85.0,20.0,36,8030,53,17
83,19,2,85.0,20.0,34,6942,126,92
86,23,2,85.0,20.0,33,8389,63,30
82,20,2,85.0,20.0,32,7302,62,30
88,22,2,85.0,20.0,36,8030,93,57
97,17,3,95.0,20.0,50,6234,1001,951
99,21,3,95.0,20.0,48,7680,69,21
91,21,3,95.0,20.0,40,7672,116,76
95,16,3,95.0,20.0,49,5871,135,86
92,17,3,95.0,20.0,45,6229,77,32
92,15,3,95.0,20.0,47,5507,142,95
93,16,3,95.0,20.0,47,5869,81,34
96,22,3,95.0,20.0,44,8038,78,34
93,22,3,95.0,20.0,41,8035,81,40
94,17,3,95.0,20.0,47,6231,75,28
106,23,4,105.0,20.0,53,8409,1001,948
107,20,4,105.0,20.0,57,7327,90,33
105,20,4,105.0,20.0,55,7325,97,42
101,23,4,105.0,20.0,48,8404,76,28
107,21,4,105.0,20.0,56,7688,111,55
108,19,4,105.0,20.0,59,6967,121,62
101,16,4,105.0,20.0,55,5877,86,31
107,17,4,105.0,20.0,60,6244,169,109
107,22,4,105.0,20.0,55,8049,77,22
102,20,4,105.0,20.0,52,7322,115,63
116,21,5,115.0,20.0,65,7697,103,38
118,24,5,115.0,20.0,64,8782,100,36
117,21,5,115.0,20.0,66,7698,106,40
116,16,5,115.0,20.0,70,5892,97,27
113,23,5,115.0,20.0,60,8416,101,41
111,23,5,115.0,20.0,58,8414,103,45
113,24,5,115.0,20.0,59,8777,125,66
116,22,5,115.0,20.0,64,8058,112,48
119,22,5,115.0,20.0,67,8061,95,28
112,21,5,115.0,20.0,61,7693,99,38
125,17,6,125.0,20.0,78,6262,146,68
121,22,6,125.0,20.0,69,8063,103,34
122,17,6,125.0,20.0,75,6259,106,31
121,17,6,125.0,20.0,74,6258,116,42
121,19,6,125.0,20.0,72,6980,94,22
121,20,6,125.0,20.0,71,7341,1001,930
128,15,6,125.0,20.0,83,5543,1001,918
127,21,6,125.0,20.0,76,7708,106,30
121,17,6,125.0,20.0,74,6258,177,103
127,24,6,125.0,20.0,73,8791,107,34
138,17,7,135.0,20.0,91,6275,132,41
134,23,7,135.0,20.0,81,8437,107,26
133,24,7,135.0,20.0,79,8797,123,44
130,20,7,135.0,20.0,80,7350,126,46
133,18,7,135.0,20.0,85,6631,125,40
132,24,7,135.0,20.0,78,8796,100,22
138,20,7,135.0,20.0,88,7358,127,39
132,23,7,135.0,20.0,79,8435,160,81
139,21,7,135.0,20.0,88,7720,142,54
136,18,7,135.0,20.0,88,6634,115,27
141,22,8,145.0,20.0,89,8083,147,58
147,15,8,145.0,20.0,102,5562,134,32
148,20,8,145.0,20.0,98,7368,121,23
148,17,8,145.0,20.0,101,6285,125,24
149,23,8,145.0,20.0,96,8452,144,48
141,24,8,145.0,20.0,87,8805,153,66
147,22,8,145.0,20.0,95,8089,147,52
142,21,8,145.0,20.0,91,7723,120,29
142,16,8,145.0,20.0,96,5918,169,73
148,18,8,145.0,20.0,100,6646,147,47
153,16,9,155.0,20.0,107,5929,157,50
156,20,9,155.0,20.0,106,7376,134,28
158,19,9,155.0,20.0,109,7017,153,44
159,17,9,155.0,20.0,112,6296,166,54
156,22,9,155.0,20.0,104,8098,145,41
154,15,9,155.0,20.0,109,5569,1001,892
153,24,9,155.0,20.0,99,8817,229,130
151,23,9,155.0,20.0,98,8454,194,96
157,16,9,155.0,20.0,111,5933,146,35
159,15,9,155.0,20.0,114,5574,218,104
166,16,10,165.0,20.0,120,5942,158,38
165,16,10,165.0,20.0,119,5941,155,36
160,15,10,165.0,20.0,115,5575,147,32
161,19,10,165.0,20.0,112,7020,133,21
164,17,10,165.0,20.0,117,6301,178,61
164,16,10,165.0,20.0,118,5940,188,70
168,19,10,165.0,20.0,119,7027,146,27
162,22,10,165.0,20.0,110,8104,169,59
168,20,10,165.0,20.0,118,7388,147,29
163,17,10,165.0,20.0,116,6300,153,37
178,23,11,175.0,20.0,125,8481,273,148
173,21,11,175.0,20.0,122,7754,175,53
170,21,11,175.0,20.0,119,7751,168,49
173,15,11,175.0,20.0,128,5588,172,44
175,19,11,175.0,20.0,126,7034,225,99
171,19,11,175.0,20.0,122,7030,147,25
178,16,11,175.0,20.0,132,5954,217,85
179,18,11,175.0,20.0,131,6677,190,59
173,20,11,175.0,20.0,123,7393,188,65
176,16,11,175.0,20.0,130,5952,162,32
183,22,12,185.0,20.0,131,8125,242,111
185,18,12,185.0,20.0,137,6683,1001,864
184,20,12,185.0,20.0,134,7404,1001,867
183,18,12,185.0,20.0,135,6681,237,102
184,19,12,185.0,20.0,135,7043,263,128
187,21,12,185.0,20.0,136,7768,1001,865
181,22,12,185.0,20.0,129,8123,1001,872
181,17,12,185.0,20.0,134,6318,235,101
185,16,12,185.0,20.0,139,5961,1001,862
184,24,12,185.0,20.0,130,8848,1001,871
196,18,13,195.0,20.0,148,6694,255,107
193,20,13,195.0,20.0,143,7413,1001,858
195,18,13,195.0,20.0,147,6693,1001,854
193,19,13,195.0,20.0,144,7052,1001,857
196,23,13,195.0,20.0,143,8499,287,144
199,15,13,195.0,20.0,154,5614,1001,847
196,19,13,195.0,20.0,147,7055,1001,854
191,21,13,195.0,20.0,140,7772,1001,861
199,18,13,195.0,20.0,151,6697,253,102
198,18,13,195.0,20.0,150,6696,242,92
208,23,14,205.0,20.0,155,8511,282,127
204,15,14,205.0,20.0,159,5619,1001,842
207,18,14,205.0,20.0,159,6705,263,104
201,15,14,205.0,20.0,156,5616,1001,845
204,18,14,205.0,20.0,156,6702,255,99
208,19,14,205.0,20.0,159,7067,266,107
205,20,14,205.0,20.0,155,7425,1001,846
202,22,14,205.0,20.0,150,8144,1001,851
206,20,14,205.0,20.0,156,7426,276,120
203,15,14,205.0,20.0,158,5618,1001,843
219,20,15,215.0,20.0,169,7439,280,111
216,15,15,215.0,20.0,171,5631,261,90
213,21,15,215.0,20.0,162,7794,262,100
214,15,15,215.0,20.0,169,5629,268,99
217,22,15,215.0,20.0,165,8159,364,199
216,22,15,215.0,20.0,164,8158,1001,837
211,18,15,215.0,20.0,163,6709,304,141
211,15,15,215.0,20.0,166,5626,259,93
210,19,15,215.0,20.0,161,7069,286,125
219,23,15,215.0,20.0,166,8522,271,105
223,18,16,225.0,20.0,175,6721,285,110
222,21,16,225.0,20.0,171,7803,270,99
225,23,16,225.0,20.0,172,8528,292,120
227,16,16,225.0,20.0,181,6003,1001,820
228,22,16,225.0,20.0,176,8170,1001,825
225,23,16,225.0,20.0,172,8528,292,120
220,22,16,225.0,20.0,168,8162,285,117
227,21,16,225.0,20.0,176,7808,281,105
225,24,16,225.0,20.0,171,8889,286,115
228,16,16,225.0,20.0,182,6004,297,115
233,17,17,235.0,20.0,186,6370,1001,815
239,23,17,235.0,20.0,186,8542,297,111
232,16,17,235.0,20.0,186,6008,1001,815
232,19,17,235.0,20.0,183,7091,305,122
233,23,17,235.0,20.0,180,8536,303,123
239,23,17,235.0,20.0,186,8542,305,119
234,17,17,235.0,20.0,187,6371,1001,814
231,16,17,235.0,20.0,185,6007,1001,816
235,21,17,235.0,20.0,184,7816,1001,817
232,18,17,235.0,20.0,184,6730,400,216
245,20,18,245.0,20.0,195,7465,352,157
241,15,18,245.0,20.0,196,5656,1001,805
240,20,18,245.0,20.0,190,7460,1001,811
245,15,18,245.0,20.0,200,5660,1001,801
242,19,18,245.0,20.0,193,7101,1001,808
243,24,18,245.0,20.0,189,8907,1001,812
248,24,18,245.0,20.0,194,8912,1001,807
246,17,18,245.0,20.0,199,6383,319,120
241,21,18,245.0,20.0,190,7822,1001,811
247,16,18,245.0,20.0,201,6023,1001,800
251,17,19,255.0,20.0,204,6388,365,161
252,22,19,255.0,20.0,200,8194,325,125
251,16,19,255.0,20.0,205,6027,320,115
255,19,19,255.0,20.0,206,7114,331,125
251,24,19,255.0,20.0,197,8915,333,136
256,18,19,255.0,20.0,208,6754,393,185
251,23,19,255.0,20.0,198,8554,320,122
258,19,19,255.0,20.0,209,7117,346,137
259,21,19,255.0,20.0,208,7840,352,144
257,24,19,255.0,20.0,203,8921,335,132
269,15,20,265.0,20.0,224,5684,385,161
267,15,20,265.0,20.0,222,5682,398,176
267,20,20,265.0,20.0,217,7487,1001,784
263,20,20,265.0,20.0,213,7483,345,132
268,16,20,265.0,20.0,222,6044,384,162
264,22,20,265.0,20.0,212,8206,1001,789
266,17,20,265.0,20.0,219,6403,392,173
269,21,20,265.0,20.0,218,7850,1001,783
267,20,20,265.0,20.0,217,7487,390,173
263,23,20,265.0,20.0,210,8566,335,125
278,18,21,275.0,20.0,230,6776,393,163
278,16,21,275.0,20.0,232,6054,377,145
279,19,21,275.0,20.0,230,7138,378,148
275,16,21,275.0,20.0,229,6051,1001,772
278,19,21,275.0,20.0,229,7137,356,127
275,21,21,275.0,20.0,224,7856,1001,777
271,20,21,275.0,20.0,221,7491,358,137
270,19,21,275.0,20.0,221,7129,400,179
276,24,21,275.0,20.0,222,8940,369,147
277,19,21,275.0,20.0,228,7136,354,126
281,23,22,285.0,20.0,228,8584,360,132
282,18,22,285.0,20.0,234,6780,375,141
285,23,22,285.0,20.0,232,8588,400,168
281,19,22,285.0,20.0,232,7140,1001,769
283,23,22,285.0,20.0,230,8586,352,122
287,15,22,285.0,20.0,242,5702,391,149
287,19,22,285.0,20.0,238,7146,393,155
283,15,22,285.0,20.0,238,5698,409,171
284,19,22,285.0,20.0,235,7143,1001,766
281,24,22,285.0,20.0,227,8945,351,124
294,20,23,295.0,20.0,244,7514,1001,757
291,19,23,295.0,20.0,242,7150,400,158
296,17,23,295.0,20.0,249,6433,1001,752
297,18,23,295.0,20.0,249,6795,414,165
294,21,23,295.0,20.0,243,7875,374,131
299,20,23,295.0,20.0,249,7519,414,165
293,18,23,295.0,20.0,245,6791,362,117
295,22,23,295.0,20.0,243,8237,1001,758
295,19,23,295.0,20.0,246,7154,402,156
291,16,23,295.0,20.0,245,6067,438,193
303,22,24,305.0,20.0,251,8245,1001,750
306,22,24,305.0,20.0,254,8248,417,163
308,15,24,305.0,20.0,263,5723,468,205
304,20,24,305.0,20.0,254,7524,487,233
305,22,24,305.0,20.0,253,8247,1001,748
308,23,24,305.0,20.0,255,8611,417,162
309,20,24,305.0,20.0,259,7529,1001,742
301,17,24,305.0,20.0,254,6438,1001,747
303,24,24,305.0,20.0,249,8967,1001,752
301,24,24,305.0,20.0,247,8965,1001,754
312,16,25,312.5,20.0,266,6088,452,186
310,15,25,312.5,20.0,265,5725,1001,736
311,20,25,312.5,20.0,261,7531,1001,740
311,19,25,312.5,20.0,262,7170,460,198
310,17,25,312.5,20.0,263,6447,425,162
311,22,25,312.5,20.0,259,8253,1001,742
311,23,25,312.5,20.0,258,8614,1001,743
312,17,25,312.5,20.0,265,6449,456,191
313,23,25,312.5,20.0,260,8616,1001,741
314,21,25,312.5,20.0,263,7895,427,164
69,31,26,65.0,30.0,10,11260,57,47
68,29,26,65.0,30.0,9,10537,20,11
63,28,26,65.0,30.0,5,10171,91,86
69,34,26,65.0,30.0,13,12343,42,29
62,32,26,65.0,30.0,4,11614,86,82
62,31,26,65.0,30.0,3,11253,39,36
65,33,26,65.0,30.0,8,11978,17,9
60,31,26,65.0,30.0,1,11251,2,1
68,32,26,65.0,30.0,10,11620,32,22
61,29,26,65.0,30.0,2,10530,69,67
75,33,27,75.0,30.0,18,11988,23,5
76,28,27,75.0,30.0,18,10184,46,28
73,34,27,75.0,30.0,17,12347,31,14
78,25,27,75.0,30.0,23,9103,60,37
78,32,27,75.0,30.0,20,11630,74,54
79,26,27,75.0,30.0,23,9465,44,21
71,25,27,75.0,30.0,16,9096,31,15
75,30,27,75.0,30.0,15,10905,123,108
79,25,27,75.0,30.0,24,9104,55,31
79,34,27,75.0,30.0,23,12353,52,29
82,33,28,85.0,30.0,25,11995,45,20
88,25,28,85.0,30.0,33,9113,50,17
81,33,28,85.0,30.0,24,11994,32,8
80,29,28,85.0,30.0,21,10549,82,61
89,31,28,85.0,30.0,30,11280,33,3
87,28,28,85.0,30.0,29,10195,108,79
87,34,28,85.0,30.0,31,12361,68,37
85,34,28,85.0,30.0,29,12359,30,1
82,31,28,85.0,30.0,23,11273,30,7
81,34,28,85.0,30.0,25,12355,50,25
98,32,29,95.0,30.0,40,11650,68,28
98,28,29,95.0,30.0,40,10206,60,20
90,31,29,95.0,30.0,31,11281,54,23
96,30,29,95.0,30.0,36,10926,69,33
98,29,29,95.0,30.0,39,10567,84,45
94,26,29,95.0,30.0,38,9480,165,127
97,26,29,95.0,30.0,41,9483,75,34
98,27,29,95.0,30.0,41,9845,113,72
92,32,29,95.0,30.0,34,11644,45,11
99,28,29,95.0,30.0,41,10207,98,57
101,30,30,105.0,30.0,41,10931,63,22
107,27,30,105.0,30.0,50,9854,114,64
101,33,30,105.0,30.0,44,12014,62,18
100,28,30,105.0,30.0,42,10208,73,31
104,34,30,105.0,30.0,48,12378,68,20
108,28,30,105.0,30.0,50,10216,88,38
102,29,30,105.0,30.0,43,10571,63,20
101,34,30,105.0,30.0,45,12375,67,22
105,28,30,105.0,30.0,47,10213,73,26
107,34,30,105.0,30.0,51,12381,74,23
113,26,31,115.0,30.0,57,9499,91,34
118,34,31,115.0,30.0,62,12392,71,9
113,31,31,115.0,30.0,54,11304,86,32
116,34,31,115.0,30.0,60,12390,90,30
116,31,31,115.0,30.0,57,11307,149,92
118,26,31,115.0,30.0,62,9504,106,44
111,33,31,115.0,30.0,54,12024,82,28
115,28,31,115.0,30.0,57,10223,92,35
117,27,31,115.0,30.0,60,9864,99,39
115,33,31,115.0,30.0,58,12028,90,32
121,27,32,125.0,30.0,64,9868,128,64
127,28,32,125.0,30.0,69,10235,155,86
124,25,32,125.0,30.0,69,9149,132,63
120,30,32,125.0,30.0,60,10950,136,76
123,31,32,125.0,30.0,64,11314,1001,937
127,34,32,125.0,30.0,71,12401,96,25
127,28,32,125.0,30.0,69,10235,116,47
126,26,32,125.0,30.0,70,9512,105,35
126,29,32,125.0,30.0,67,10595,123,56
126,33,32,125.0,30.0,69,12039,121,52
134,33,33,135.0,30.0,77,12047,111,34
138,28,33,135.0,30.0,80,10246,143,63
133,29,33,135.0,30.0,74,10602,100,26
133,30,33,135.0,30.0,73,10963,112,39
139,28,33,135.0,30.0,81,10247,110,29
138,27,33,135.0,30.0,81,9885,139,58
133,27,33,135.0,30.0,76,9880,103,27
130,29,33,135.0,30.0,71,10599,103,32
137,29,33,135.0,30.0,78,10606,155,77
130,26,33,135.0,30.0,74,9516,1001,927
141,31,34,145.0,30.0,82,11332,151,69
140,25,34,145.0,30.0,85,9165,142,57
141,29,34,145.0,30.0,82,10610,241,159
146,28,34,145.0,30.0,88,10254,173,85
144,28,34,145.0,30.0,86,10252,137,51
146,27,34,145.0,30.0,89,9893,120,31
148,30,34,145.0,30.0,88,10978,152,64
140,30,34,145.0,30.0,80,10970,137,57
144,34,34,145.0,30.0,88,12418,102,14
140,34,34,145.0,30.0,84,12414,129,45
157,25,35,155.0,30.0,102,9182,187,85
155,26,35,155.0,30.0,99,9541,142,43
150,28,35,155.0,30.0,92,10258,1001,909
151,29,35,155.0,30.0,92,10620,121,29
156,25,35,155.0,30.0,101,9181,235,134
157,31,35,155.0,30.0,98,11348,173,75
157,29,35,155.0,30.0,98,10626,159,61
150,31,35,155.0,30.0,91,11341,117,26
156,28,35,155.0,30.0,98,10264,126,28
155,33,35,155.0,30.0,98,12068,122,24
160,30,36,165.0,30.0,100,10990,194,94
161,26,36,165.0,30.0,105,9547,213,108
167,27,36,165.0,30.0,110,9914,189,79
161,28,36,165.0,30.0,103,10269,150,47
164,28,36,165.0,30.0,106,10272,162,56
168,34,36,165.0,30.0,112,12442,150,38
161,29,36,165.0,30.0,102,10630,1001,899
168,27,36,165.0,30.0,111,9915,144,33
167,34,36,165.0,30.0,111,12441,129,18
161,33,36,165.0,30.0,104,12074,324,220
179,30,37,175.0,30.0,119,11009,209,90
172,28,37,175.0,30.0,114,10280,166,52
170,27,37,175.0,30.0,113,9917,162,49
179,27,37,175.0,30.0,122,9926,182,60
178,25,37,175.0,30.0,123,9203,164,41
175,27,37,175.0,30.0,118,9922,197,79
170,25,37,175.0,30.0,115,9195,170,55
174,31,37,175.0,30.0,115,11365,1001,886
170,30,37,175.0,30.0,110,11000,136,26
173,33,37,175.0,30.0,116,12086,156,40
184,26,38,185.0,30.0,128,9570,1001,873
187,31,38,185.0,30.0,128,11378,1001,873
185,33,38,185.0,30.0,128,12098,1001,873
186,26,38,185.0,30.0,130,9572,1001,871
182,26,38,185.0,30.0,126,9568,1001,875
186,29,38,185.0,30.0,127,10655,1001,874
181,30,38,185.0,30.0,121,11011,1001,880
188,31,38,185.0,30.0,129,11379,1001,872
183,31,38,185.0,30.0,124,11374,1001,877
185,34,38,185.0,30.0,129,12459,1001,872
197,31,39,195.0,30.0,138,11388,1001,863
197,26,39,195.0,30.0,141,9583,1001,860
192,29,39,195.0,30.0,133,10661,1001,868
191,31,39,195.0,30.0,132,11382,1001,869
194,34,39,195.0,30.0,138,12468,1001,863
195,31,39,195.0,30.0,136,11386,299,163
193,26,39,195.0,30.0,137,9579,1001,864
197,26,39,195.0,30.0,141,9583,284,143
193,29,39,195.0,30.0,134,10662,1001,867
193,27,39,195.0,30.0,136,9940,1001,865
209,32,40,205.0,30.0,151,11761,1001,850
208,34,40,205.0,30.0,152,12482,356,204
206,28,40,205.0,30.0,148,10314,282,134
203,26,40,205.0,30.0,147,9589,305,158
206,26,40,205.0,30.0,150,9592,302,152
208,28,40,205.0,30.0,150,10316,273,123
201,30,40,205.0,30.0,141,11031,424,283
206,34,40,205.0,30.0,150,12480,291,141
204,28,40,205.0,30.0,146,10312,296,150
202,28,40,205.0,30.0,144,10310,1001,857
214,25,41,215.0,30.0,159,9239,309,150
217,28,41,215.0,30.0,159,10325,343,184
217,26,41,215.0,30.0,161,9603,286,125
212,34,41,215.0,30.0,156,12486,306,150
217,30,41,215.0,30.0,157,11047,337,180
210,31,41,215.0,30.0,151,11401,314,163
210,32,41,215.0,30.0,152,11762,324,172
215,32,41,215.0,30.0,157,11767,1001,844
217,27,41,215.0,30.0,160,9964,337,177
219,30,41,215.0,30.0,159,11049,289,130
226,29,42,225.0,30.0,167,10695,307,140
221,34,42,225.0,30.0,165,12495,307,142
224,30,42,225.0,30.0,164,11054,319,155
223,33,42,225.0,30.0,166,12136,347,181
224,31,42,225.0,30.0,165,11415,308,143
227,31,42,225.0,30.0,168,11418,400,232
226,29,42,225.0,30.0,167,10695,309,142
224,31,42,225.0,30.0,165,11415,317,152
222,25,42,225.0,30.0,167,9247,297,130
228,34,42,225.0,30.0,172,12502,314,142
234,29,43,235.0,30.0,175,10703,1001,826
235,31,43,235.0,30.0,176,11426,307,131
238,30,43,235.0,30.0,178,11068,354,176
236,34,43,235.0,30.0,180,12510,362,182
233,27,43,235.0,30.0,176,9980,293,117
231,27,43,235.0,30.0,174,9978,295,121
232,32,43,235.0,30.0,174,11784,1001,827
235,30,43,235.0,30.0,175,11065,351,176
231,32,43,235.0,30.0,173,11783,338,165
236,27,43,235.0,30.0,179,9983,321,142
242,28,44,245.0,30.0,184,10350,362,178
244,30,44,245.0,30.0,184,11074,375,191
249,25,44,245.0,30.0,194,9274,347,153
241,28,44,245.0,30.0,183,10349,1001,818
245,34,44,245.0,30.0,189,12519,399,210
244,30,44,245.0,30.0,184,11074,322,138
246,30,44,245.0,30.0,186,11076,383,197
246,30,44,245.0,30.0,186,11076,319,133
240,28,44,245.0,30.0,182,10348,1001,819
249,34,44,245.0,30.0,193,12523,350,157
259,29,45,255.0,30.0,200,10728,423,223
253,34,45,255.0,30.0,197,12527,389,192
259,34,45,255.0,30.0,203,12533,364,161
250,31,45,255.0,30.0,191,11441,1001,810
251,28,45,255.0,30.0,193,10359,1001,808
259,31,45,255.0,30.0,200,11450,362,162
254,33,45,255.0,30.0,197,12167,354,157
250,26,45,255.0,30.0,194,9636,1001,807
256,25,45,255.0,30.0,201,9281,326,125
251,27,45,255.0,30.0,194,9998,338,144
264,30,46,265.0,30.0,204,11094,332,128
262,30,46,265.0,30.0,202,11092,348,146
262,32,46,265.0,30.0,204,11814,355,151
265,27,46,265.0,30.0,208,10012,348,140
268,33,46,265.0,30.0,211,12181,355,144
266,29,46,265.0,30.0,207,10735,1001,794
260,27,46,265.0,30.0,203,10007,347,144
264,34,46,265.0,30.0,208,12538,408,200
268,32,46,265.0,30.0,210,11820,412,202
263,28,46,265.0,30.0,205,10371,1001,796
272,25,47,275.0,30.0,217,9297,370,153
274,29,47,275.0,30.0,215,10743,373,158
277,33,47,275.0,30.0,220,12190,411,191
277,34,47,275.0,30.0,221,12551,406,185
278,34,47,275.0,30.0,222,12552,1001,779
277,27,47,275.0,30.0,220,10024,346,126
278,28,47,275.0,30.0,220,10386,1001,781
270,30,47,275.0,30.0,210,11100,365,155
278,28,47,275.0,30.0,220,10386,368,148
279,30,47,275.0,30.0,219,11109,385,166
284,26,48,285.0,30.0,228,9670,381,153
288,33,48,285.0,30.0,231,12201,395,164
288,34,48,285.0,30.0,232,12562,371,139
286,30,48,285.0,30.0,226,11116,380,154
287,34,48,285.0,30.0,231,12561,395,164
281,31,48,285.0,30.0,222,11472,410,188
282,26,48,285.0,30.0,226,9668,354,128
284,31,48,285.0,30.0,225,11475,1001,776
283,33,48,285.0,30.0,226,12196,410,184
281,29,48,285.0,30.0,222,10750,378,156
290,31,49,295.0,30.0,231,11481,385,154
295,28,49,295.0,30.0,237,10403,358,121
292,33,49,295.0,30.0,235,12205,388,153
293,33,49,295.0,30.0,236,12206,391,155
297,29,49,295.0,30.0,238,10766,422,184
295,27,49,295.0,30.0,238,10042,393,155
296,31,49,295.0,30.0,237,11487,431,194
293,26,49,295.0,30.0,237,9679,382,145
297,31,49,295.0,30.0,238,11488,417,179
298,28,49,295.0,30.0,240,10406,1001,761
306,26,50,305.0,30.0,250,9692,411,161
306,30,50,305.0,30.0,246,11136,1001,755
307,34,50,305.0,30.0,251,12581,1001,750
300,30,50,305.0,30.0,240,11130,1001,761
301,29,50,305.0,30.0,242,10770,1001,759
304,31,50,305.0,30.0,245,11495,1001,756
307,33,50,305.0,30.0,250,12220,1001,751
301,29,50,305.0,30.0,242,10770,1001,759
308,29,50,305.0,30.0,249,10777,408,159
305,33,50,305.0,30.0,248,12218,1001,753
313,26,51,312.5,30.0,257,9699,425,168
312,32,51,312.5,30.0,254,11864,1001,747
312,32,51,312.5,30.0,254,11864,428,174
311,31,51,312.5,30.0,252,11502,428,176
310,32,51,312.5,30.0,252,11862,1001,749
314,30,51,312.5,30.0,254,11144,431,177
313,30,51,312.5,30.0,253,11143,423,170
313,31,51,312.5,30.0,254,11504,1001,747
312,25,51,312.5,30.0,257,9337,1001,744
312,28,51,312.5,30.0,254,10420,425,171
65,36,52,65.0,40.0,11,13061,26,15
63,36,52,65.0,40.0,9,13059,79,70
65,43,52,65.0,40.0,18,15588,74,56
61,44,52,65.0,40.0,15,15945,56,41
60,43,52,65.0,40.0,13,15583,54,41
60,44,52,65.0,40.0,14,15944,55,41
64,40,52,65.0,40.0,14,14504,69,55
68,43,52,65.0,40.0,21,15591,90,69
69,37,52,65.0,40.0,16,13426,67,51
64,44,52,65.0,40.0,18,15948,126,108
79,37,53,75.0,40.0,26,13436,48,22
73,44,53,75.0,40.0,27,15957,77,50
79,43,53,75.0,40.0,32,15602,72,40
76,38,53,75.0,40.0,24,13794,41,17
78,38,53,75.0,40.0,26,13796,67,41
74,37,53,75.0,40.0,21,13431,64,43
74,35,53,75.0,40.0,19,12709,50,31
70,40,53,75.0,40.0,20,14510,46,26
76,43,53,75.0,40.0,29,15599,104,75
76,39,53,75.0,40.0,25,14155,57,32
83,43,54,85.0,40.0,36,15606,226,190
87,41,54,85.0,40.0,38,14888,61,23
89,39,54,85.0,40.0,38,14168,51,13
87,37,54,85.0,40.0,34,13444,48,14
81,37,54,85.0,40.0,28,13438,39,11
80,42,54,85.0,40.0,32,15242,87,55
84,44,54,85.0,40.0,38,15968,85,47
88,44,54,85.0,40.0,42,15972,85,43
87,42,54,85.0,40.0,39,15249,83,44
81,37,54,85.0,40.0,28,13438,42,14
92,35,55,95.0,40.0,37,12727,81,44
93,43,55,95.0,40.0,46,15616,1001,955
99,36,55,95.0,40.0,45,13095,70,25
99,42,55,95.0,40.0,51,15261,100,49
95,37,55,95.0,40.0,42,13452,69,27
92,44,55,95.0,40.0,46,15976,114,68
94,40,55,95.0,40.0,44,14534,84,40
96,43,55,95.0,40.0,49,15619,93,44
90,37,55,95.0,40.0,37,13447,59,22
97,36,55,95.0,40.0,43,13093,50,7
108,38,56,105.0,40.0,56,13826,77,21
103,42,56,105.0,40.0,55,15265,88,33
106,42,56,105.0,40.0,58,15268,107,49
101,44,56,105.0,40.0,55,15985,105,50
107,38,56,105.0,40.0,55,13825,106,51
108,42,56,105.0,40.0,60,15270,109,49
104,42,56,105.0,40.0,56,15266,112,56
107,35,56,105.0,40.0,52,12742,61,9
107,40,56,105.0,40.0,57,14547,74,17
102,37,56,105.0,40.0,49,13459,78,29
118,36,57,115.0,40.0,64,13114,106,42
115,35,57,115.0,40.0,60,12750,112,52
116,35,57,115.0,40.0,61,12751,97,36
114,35,57,115.0,40.0,59,12749,85,26
110,35,57,115.0,40.0,55,12745,83,28
111,40,57,115.0,40.0,61,14551,110,49
115,42,57,115.0,40.0,67,15277,168,101
119,42,57,115.0,40.0,71,15281,126,55
114,41,57,115.0,40.0,65,14915,127,62
112,44,57,115.0,40.0,66,15996,117,51
128,43,58,125.0,40.0,81,15651,158,77
120,38,58,125.0,40.0,68,13838,89,21
120,41,58,125.0,40.0,71,14921,148,77
121,42,58,125.0,40.0,73,15283,135,62
126,38,58,125.0,40.0,74,13844,85,11
129,41,58,125.0,40.0,80,14930,109,29
126,44,58,125.0,40.0,80,16010,148,68
120,44,58,125.0,40.0,74,16004,120,46
124,36,58,125.0,40.0,70,13120,88,18
122,39,58,125.0,40.0,71,14201,135,64
134,42,59,135.0,40.0,86,15296,109,23
137,37,59,135.0,40.0,84,13494,119,35
131,41,59,135.0,40.0,82,14932,157,75
133,43,59,135.0,40.0,86,15656,163,77
131,40,59,135.0,40.0,81,14571,113,32
130,37,59,135.0,40.0,77,13487,92,15
131,39,59,135.0,40.0,80,14210,113,33
137,42,59,135.0,40.0,89,15299,130,41
136,40,59,135.0,40.0,86,14576,141,55
139,41,59,135.0,40.0,90,14940,140,50
149,37,60,145.0,40.0,96,13506,139,43
144,35,60,145.0,40.0,89,12779,112,23
144,42,60,145.0,40.0,96,15306,161,65
144,38,60,145.0,40.0,92,13862,177,85
147,44,60,145.0,40.0,101,16031,161,60
141,40,60,145.0,40.0,91,14581,116,25
149,41,60,145.0,40.0,100,14950,1001,901
145,42,60,145.0,40.0,97,15307,1001,904
148,42,60,145.0,40.0,100,15310,153,53
146,39,60,145.0,40.0,95,14225,126,31
154,38,61,155.0,40.0,102,13872,121,19
157,43,61,155.0,40.0,110,15680,173,63
159,40,61,155.0,40.0,109,14599,183,74
159,40,61,155.0,40.0,109,14599,151,42
158,37,61,155.0,40.0,105,13515,151,46
158,43,61,155.0,40.0,111,15681,160,49
158,35,61,155.0,40.0,103,12793,1001,898
153,42,61,155.0,40.0,105,15315,182,77
152,40,61,155.0,40.0,102,14592,167,65
150,42,61,155.0,40.0,102,15312,128,26
169,40,62,165.0,40.0,119,14609,197,78
162,35,62,165.0,40.0,107,12797,145,38
161,41,62,165.0,40.0,112,14962,187,75
161,38,62,165.0,40.0,109,13879,124,15
160,44,62,165.0,40.0,114,16044,1001,887
160,37,62,165.0,40.0,107,13517,123,16
162,35,62,165.0,40.0,107,12797,152,45
160,43,62,165.0,40.0,113,15683,1001,888
169,41,62,165.0,40.0,120,14970,187,67
164,42,62,165.0,40.0,116,15326,1001,885
171,38,63,175.0,40.0,119,13889,215,96
173,44,63,175.0,40.0,127,16057,198,71
170,43,63,175.0,40.0,123,15693,176,53
177,37,63,175.0,40.0,124,13534,130,6
171,44,63,175.0,40.0,125,16055,191,66
173,43,63,175.0,40.0,126,15696,193,67
178,36,63,175.0,40.0,124,13174,142,18
172,42,63,175.0,40.0,124,15334,189,65
173,35,63,175.0,40.0,118,12808,136,18
174,44,63,175.0,40.0,128,16058,186,58
189,40,64,185.0,40.0,139,14629,1001,862
182,40,64,185.0,40.0,132,14622,1001,869
185,41,64,185.0,40.0,136,14986,287,151
184,44,64,185.0,40.0,138,16068,1001,863
187,40,64,185.0,40.0,137,14627,1001,864
187,43,64,185.0,40.0,140,15710,1001,861
186,42,64,185.0,40.0,138,15348,1001,863
189,38,64,185.0,40.0,137,13907,1001,864
186,37,64,185.0,40.0,133,13543,1001,868
188,37,64,185.0,40.0,135,13545,1001,866
195,44,65,195.0,40.0,149,16079,345,196
196,39,65,195.0,40.0,145,14275,1001,856
195,38,65,195.0,40.0,143,13913,1001,858
190,39,65,195.0,40.0,139,14269,1001,862
199,40,65,195.0,40.0,149,14639,1001,852
192,39,65,195.0,40.0,141,14271,1001,860
196,39,65,195.0,40.0,145,14275,1001,856
192,38,65,195.0,40.0,140,13910,1001,861
199,42,65,195.0,40.0,151,15361,1001,850
193,35,65,195.0,40.0,138,12828,1001,863
206,35,66,205.0,40.0,151,12841,295,144
206,37,66,205.0,40.0,153,13563,323,170
200,37,66,205.0,40.0,147,13557,279,132
201,44,66,205.0,40.0,155,16085,1001,846
204,43,66,205.0,40.0,157,15727,1001,844
204,43,66,205.0,40.0,157,15727,293,136
201,43,66,205.0,40.0,154,15724,1001,847
205,35,66,205.0,40.0,150,12840,278,128
200,35,66,205.0,40.0,145,12835,372,227
204,38,66,205.0,40.0,152,13922,1001,849
219,43,67,215.0,40.0,172,15742,334,162
211,43,67,215.0,40.0,164,15734,405,241
210,39,67,215.0,40.0,159,14289,311,152
218,40,67,215.0,40.0,168,14658,300,132
215,36,67,215.0,40.0,161,13211,350,189
212,37,67,215.0,40.0,159,13569,308,149
211,44,67,215.0,40.0,165,16095,314,149
215,35,67,215.0,40.0,160,12850,316,156
215,43,67,215.0,40.0,168,15738,334,166
218,36,67,215.0,40.0,164,13214,295,131
221,42,68,225.0,40.0,173,15383,375,202
223,40,68,225.0,40.0,173,14663,364,191
228,36,68,225.0,40.0,174,13224,307,133
227,38,68,225.0,40.0,175,13945,1001,826
228,37,68,225.0,40.0,175,13585,346,171
228,40,68,225.0,40.0,178,14668,428,250
222,37,68,225.0,40.0,169,13579,325,156
227,44,68,225.0,40.0,181,16111,337,156
226,40,68,225.0,40.0,176,14666,364,188
222,37,68,225.0,40.0,169,13579,322,153
239,42,69,235.0,40.0,191,15401,332,141
237,38,69,235.0,40.0,185,13955,329,144
232,36,69,235.0,40.0,178,13228,315,137
238,42,69,235.0,40.0,190,15400,355,165
234,39,69,235.0,40.0,183,14313,331,148
238,37,69,235.0,40.0,185,13595,362,177
238,39,69,235.0,40.0,187,14317,327,140
230,42,69,235.0,40.0,182,15392,341,159
230,44,69,235.0,40.0,184,16114,318,134
238,38,69,235.0,40.0,186,13956,349,163
249,40,70,245.0,40.0,199,14689,379,180
242,44,70,245.0,40.0,196,16126,345,149
244,36,70,245.0,40.0,190,13240,350,160
241,40,70,245.0,40.0,191,14681,370,179
243,40,70,245.0,40.0,193,14683,361,168
247,37,70,245.0,40.0,194,13604,374,180
243,35,70,245.0,40.0,188,12878,377,189
240,40,70,245.0,40.0,190,14680,352,162
244,36,70,245.0,40.0,190,13240,343,153
240,43,70,245.0,40.0,193,15763,336,143
253,43,71,255.0,40.0,206,15776,368,162
259,44,71,255.0,40.0,213,16143,356,143
250,43,71,255.0,40.0,203,15773,344,141
251,39,71,255.0,40.0,200,14330,409,209
257,43,71,255.0,40.0,210,15780,429,219
259,41,71,255.0,40.0,210,15060,356,146
257,37,71,255.0,40.0,204,13614,348,144
252,43,71,255.0,40.0,205,15775,1001,796
252,42,71,255.0,40.0,204,15414,395,191
259,37,71,255.0,40.0,206,13616,351,145
265,40,72,265.0,40.0,215,14705,369,154
262,40,72,265.0,40.0,212,14702,392,180
264,37,72,265.0,40.0,211,13621,1001,790
268,43,72,265.0,40.0,221,15791,376,155
262,35,72,265.0,40.0,207,12897,359,152
265,39,72,265.0,40.0,214,14344,398,184
265,37,72,265.0,40.0,212,13622,406,194
265,41,72,265.0,40.0,216,15066,376,160
260,35,72,265.0,40.0,205,12895,1001,796
260,44,72,265.0,40.0,214,16144,402,188
276,42,73,275.0,40.0,228,15438,365,137
272,41,73,275.0,40.0,223,15073,368,145
277,38,73,275.0,40.0,225,13995,504,279
279,37,73,275.0,40.0,226,13636,371,145
271,44,73,275.0,40.0,225,16155,391,166
275,36,73,275.0,40.0,221,13271,358,137
274,40,73,275.0,40.0,224,14714,413,189
278,37,73,275.0,40.0,225,13635,361,136
275,40,73,275.0,40.0,225,14715,388,163
276,37,73,275.0,40.0,223,13633,379,156
284,44,74,285.0,40.0,238,16168,414,176
289,37,74,285.0,40.0,236,13646,391,155
281,42,74,285.0,40.0,233,15443,384,151
285,35,74,285.0,40.0,230,12920,460,230
289,44,74,285.0,40.0,243,16173,398,155
282,36,74,285.0,40.0,228,13278,1001,773
283,37,74,285.0,40.0,230,13640,463,233
286,41,74,285.0,40.0,237,15087,389,152
282,43,74,285.0,40.0,235,15805,378,143
282,36,74,285.0,40.0,228,13278,369,141
298,38,75,295.0,40.0,246,14016,395,149
291,39,75,295.0,40.0,240,14370,402,162
291,43,75,295.0,40.0,244,15814,418,174
290,37,75,295.0,40.0,237,13647,390,153
299,36,75,295.0,40.0,245,13295,1001,756
296,41,75,295.0,40.0,247,15097,405,158
297,39,75,295.0,40.0,246,14376,397,151
297,43,75,295.0,40.0,250,15820,383,133
294,36,75,295.0,40.0,240,13290,1001,761
290,38,75,295.0,40.0,238,14008,367,129
306,37,76,305.0,40.0,253,13663,446,193
309,40,76,305.0,40.0,259,14749,433,174
303,36,76,305.0,40.0,249,13299,1001,752
300,39,76,305.0,40.0,249,14379,405,156
302,38,76,305.0,40.0,250,14020,395,145
308,44,76,305.0,40.0,262,16192,410,148
309,44,76,305.0,40.0,263,16193,403,140
307,38,76,305.0,40.0,255,14025,1001,746
304,39,76,305.0,40.0,253,14383,420,167
300,41,76,305.0,40.0,251,15101,431,180
312,38,77,312.5,40.0,260,14030,408,148
311,36,77,312.5,40.0,257,13307,1001,744
311,41,77,312.5,40.0,262,15112,410,148
313,42,77,312.5,40.0,265,15475,407,142
313,38,77,312.5,40.0,261,14031,417,156
311,44,77,312.5,40.0,265,16195,417,152
314,42,77,312.5,40.0,266,15476,568,302
310,42,77,312.5,40.0,262,15472,400,138
312,39,77,312.5,40.0,261,14391,1001,740
310,37,77,312.5,40.0,257,13667,1001,744
