x,y,cell,cell_x,cell_y,opt_traj,point_id,steps_taken,extra_steps
60,17,0,65.0,20.0,13,6197,36,23
68,19,0,65.0,20.0,19,6927,40,21
60,24,0,65.0,20.0,6,8724,21,15
62,15,0,65.0,20.0,17,5477,99,82
64,17,0,65.0,20.0,17,6201,91,74
68,16,0,65.0,20.0,22,5844,53,31
60,15,0,65.0,20.0,15,5475,1001,986
60,23,0,65.0,20.0,7,8363,22,15
65,22,0,65.0,20.0,13,8007,34,21
63,21,0,65.0,20.0,12,7644,59,47
77,24,1,75.0,20.0,23,8741,60,37
79,19,1,75.0,20.0,30,6938,48,18
74,15,1,75.0,20.0,29,5489,105,76
74,23,1,75.0,20.0,21,8377,59,38
79,22,1,75.0,20.0,27,8021,67,40
74,21,1,75.0,20.0,23,7655,38,15
76,22,1,75.0,20.0,24,8018,43,19
75,23,1,75.0,20.0,22,8378,71,49
78,19,1,75.0,20.0,29,6937,53,24
74,23,1,75.0,20.0,21,8377,40,19
85,18,2,85.0,20.0,37,6583,55,18
86,21,2,85.0,20.0,35,7667,62,27
82,23,2,85.0,20.0,29,8385,91,62
89,18,2,85.0,20.0,41,6587,61,20
86,23,2,85.0,20.0,33,8389,61,28
80,20,2,85.0,20.0,30,7300,64,34
83,19,2,85.0,20.0,34,6942,64,30
81,23,2,85.0,20.0,28,8384,51,23
88,20,2,85.0,20.0,38,7308,81,43
84,22,2,85.0,20.0,32,8026,60,28
94,23,3,95.0,20.0,41,8397,64,23
94,23,3,95.0,20.0,41,8397,65,24
96,16,3,95.0,20.0,50,5872,96,46
91,18,3,95.0,20.0,43,6589,68,25
92,22,3,95.0,20.0,40,8034,84,44
99,22,3,95.0,20.0,47,8041,68,21
90,19,3,95.0,20.0,41,6949,70,29
93,21,3,95.0,20.0,42,7674,100,58
92,23,3,95.0,20.0,39,8395,66,27
95,20,3,95.0,20.0,45,7315,67,22
108,22,4,105.0,20.0,56,8050,88,32
109,19,4,105.0,20.0,60,6968,87,27
105,22,4,105.0,20.0,53,8047,77,24
100,24,4,105.0,20.0,46,8764,74,28
102,17,4,105.0,20.0,55,6239,94,39
103,22,4,105.0,20.0,51,8045,83,32
105,23,4,105.0,20.0,52,8408,98,46
105,20,4,105.0,20.0,55,7325,73,18
106,21,4,105.0,20.0,55,7687,126,71
100,20,4,105.0,20.0,50,7320,118,68
115,19,5,115.0,20.0,66,6974,110,44
111,18,5,115.0,20.0,63,6609,100,37
119,24,5,115.0,20.0,65,8783,105,40
113,19,5,115.0,20.0,64,6972,108,44
119,15,5,115.0,20.0,74,5534,162,88
118,24,5,115.0,20.0,64,8782,137,73
118,17,5,115.0,20.0,71,6255,112,41
118,20,5,115.0,20.0,68,7338,97,29
118,23,5,115.0,20.0,65,8421,155,90
111,20,5,115.0,20.0,61,7331,83,22
120,17,6,125.0,20.0,73,6257,117,44
120,23,6,125.0,20.0,67,8423,129,62
127,23,6,125.0,20.0,74,8430,112,38
120,15,6,125.0,20.0,75,5535,102,27
126,22,6,125.0,20.0,74,8068,127,53
121,22,6,125.0,20.0,69,8063,111,42
127,15,6,125.0,20.0,82,5542,126,44
121,21,6,125.0,20.0,70,7702,106,36
127,21,6,125.0,20.0,76,7708,132,56
127,16,6,125.0,20.0,81,5903,148,67
136,16,7,135.0,20.0,90,5912,169,79
139,24,7,135.0,20.0,85,8803,143,58
136,24,7,135.0,20.0,82,8800,109,27
138,24,7,135.0,20.0,84,8802,146,62
134,22,7,135.0,20.0,82,8076,146,64
137,19,7,135.0,20.0,88,6996,135,47
137,21,7,135.0,20.0,86,7718,137,51
139,16,7,135.0,20.0,93,5915,116,23
136,24,7,135.0,20.0,82,8800,113,31
130,23,7,135.0,20.0,77,8433,117,40
148,15,8,145.0,20.0,103,5563,193,90
140,21,8,145.0,20.0,89,7721,144,55
146,22,8,145.0,20.0,94,8088,145,51
142,23,8,145.0,20.0,89,8445,130,41
142,21,8,145.0,20.0,91,7723,145,54
148,15,8,145.0,20.0,103,5563,197,94
149,17,8,145.0,20.0,102,6286,150,48
140,15,8,145.0,20.0,95,5555,199,104
149,18,8,145.0,20.0,101,6647,145,44
148,23,8,145.0,20.0,95,8451,143,48
154,15,9,155.0,20.0,109,5569,207,98
151,15,9,155.0,20.0,106,5566,155,49
156,15,9,155.0,20.0,111,5571,158,47
150,23,9,155.0,20.0,97,8453,130,33
153,15,9,155.0,20.0,108,5568,225,117
155,21,9,155.0,20.0,104,7736,142,38
152,24,9,155.0,20.0,98,8816,1001,903
154,16,9,155.0,20.0,108,5930,203,95
152,21,9,155.0,20.0,101,7733,157,56
159,19,9,155.0,20.0,110,7018,149,39
162,17,10,165.0,20.0,115,6299,156,41
165,15,10,165.0,20.0,120,5580,188,68
163,20,10,165.0,20.0,113,7383,164,51
167,20,10,165.0,20.0,117,7387,1001,884
167,20,10,165.0,20.0,117,7387,179,62
168,18,10,165.0,20.0,120,6666,1001,881
160,15,10,165.0,20.0,115,5575,1001,886
162,23,10,165.0,20.0,109,8465,195,86
167,16,10,165.0,20.0,121,5943,173,52
166,16,10,165.0,20.0,120,5942,238,118
173,24,11,175.0,20.0,119,8837,171,52
172,23,11,175.0,20.0,119,8475,171,52
177,19,11,175.0,20.0,128,7036,180,52
176,17,11,175.0,20.0,129,6313,179,50
178,24,11,175.0,20.0,124,8842,163,39
178,20,11,175.0,20.0,128,7398,205,77
176,17,11,175.0,20.0,129,6313,1001,872
179,16,11,175.0,20.0,133,5955,202,69
170,17,11,175.0,20.0,123,6307,1001,878
175,23,11,175.0,20.0,122,8478,178,56
186,24,12,185.0,20.0,132,8850,1001,869
180,23,12,185.0,20.0,127,8483,180,53
189,22,12,185.0,20.0,137,8131,1001,864
187,15,12,185.0,20.0,142,5602,238,96
185,17,12,185.0,20.0,138,6322,1001,863
181,21,12,185.0,20.0,130,7762,1001,871
189,16,12,185.0,20.0,143,5965,1001,858
182,16,12,185.0,20.0,136,5958,1001,865
185,21,12,185.0,20.0,134,7766,1001,867
185,24,12,185.0,20.0,131,8849,1001,870
194,17,13,195.0,20.0,147,6331,1001,854
191,24,13,195.0,20.0,137,8855,1001,864
194,20,13,195.0,20.0,144,7414,1001,857
192,15,13,195.0,20.0,147,5607,1001,854
194,15,13,195.0,20.0,149,5609,1001,852
194,23,13,195.0,20.0,141,8497,1001,860
199,20,13,195.0,20.0,149,7419,1001,852
195,15,13,195.0,20.0,150,5610,1001,851
193,20,13,195.0,20.0,143,7413,1001,858
190,23,13,195.0,20.0,137,8493,1001,864
201,23,14,205.0,20.0,148,8504,1001,853
200,19,14,205.0,20.0,151,7059,1001,850
204,19,14,205.0,20.0,155,7063,1001,846
203,16,14,205.0,20.0,157,5979,1001,844
204,21,14,205.0,20.0,153,7785,1001,848
207,19,14,205.0,20.0,158,7066,1001,843
205,21,14,205.0,20.0,154,7786,1001,847
204,20,14,205.0,20.0,154,7424,1001,847
206,16,14,205.0,20.0,160,5982,1001,841
208,19,14,205.0,20.0,159,7067,1001,842
214,19,15,215.0,20.0,165,7073,1001,836
211,18,15,215.0,20.0,163,6709,1001,838
219,16,15,215.0,20.0,173,5995,1001,828
214,22,15,215.0,20.0,162,8156,1001,839
215,21,15,215.0,20.0,164,7796,1001,837
213,17,15,215.0,20.0,166,6350,1001,835
211,17,15,215.0,20.0,164,6348,1001,837
216,24,15,215.0,20.0,162,8880,1001,839
214,21,15,215.0,20.0,163,7795,1001,838
216,22,15,215.0,20.0,164,8158,1001,837
225,21,16,225.0,20.0,174,7806,1001,827
224,17,16,225.0,20.0,177,6361,285,108
225,19,16,225.0,20.0,176,7084,289,113
227,18,16,225.0,20.0,179,6725,1001,822
221,18,16,225.0,20.0,173,6719,278,105
228,20,16,225.0,20.0,178,7448,1001,823
221,19,16,225.0,20.0,172,7080,1001,829
225,20,16,225.0,20.0,175,7445,1001,826
221,23,16,225.0,20.0,168,8524,1001,833
221,22,16,225.0,20.0,169,8163,1001,832
232,19,17,235.0,20.0,183,7091,1001,818
234,21,17,235.0,20.0,183,7815,1001,818
235,16,17,235.0,20.0,189,6011,1001,812
235,20,17,235.0,20.0,185,7455,1001,816
239,22,17,235.0,20.0,187,8181,1001,814
233,22,17,235.0,20.0,181,8175,1001,820
230,18,17,235.0,20.0,182,6728,1001,819
238,23,17,235.0,20.0,185,8541,1001,816
236,16,17,235.0,20.0,190,6012,1001,811
239,15,17,235.0,20.0,194,5654,1001,807
247,16,18,245.0,20.0,201,6023,1001,800
243,20,18,245.0,20.0,193,7463,1001,808
242,19,18,245.0,20.0,193,7101,1001,808
241,23,18,245.0,20.0,188,8544,1001,813
240,20,18,245.0,20.0,190,7460,1001,811
249,24,18,245.0,20.0,195,8913,1001,806
242,21,18,245.0,20.0,191,7823,1001,810
240,16,18,245.0,20.0,194,6016,1001,807
242,19,18,245.0,20.0,193,7101,1001,808
246,15,18,245.0,20.0,201,5661,1001,800
251,15,19,255.0,20.0,206,5666,1001,795
250,20,19,255.0,20.0,200,7470,1001,801
259,17,19,255.0,20.0,212,6396,1001,789
250,20,19,255.0,20.0,200,7470,1001,801
259,23,19,255.0,20.0,206,8562,1001,795
255,16,19,255.0,20.0,209,6031,1001,792
250,16,19,255.0,20.0,204,6026,1001,797
253,22,19,255.0,20.0,201,8195,1001,800
253,21,19,255.0,20.0,202,7834,1001,799
257,21,19,255.0,20.0,206,7838,1001,795
261,20,20,265.0,20.0,211,7481,1001,790
260,15,20,265.0,20.0,215,5675,1001,786
265,21,20,265.0,20.0,214,7846,1001,787
264,17,20,265.0,20.0,217,6401,1001,784
261,23,20,265.0,20.0,208,8564,1001,793
263,23,20,265.0,20.0,210,8566,1001,791
262,24,20,265.0,20.0,208,8926,1001,793
266,24,20,265.0,20.0,212,8930,1001,789
263,24,20,265.0,20.0,209,8927,1001,792
260,15,20,265.0,20.0,215,5675,1001,786
271,15,21,275.0,20.0,226,5686,1001,775
271,15,21,275.0,20.0,226,5686,1001,775
275,15,21,275.0,20.0,230,5690,1001,771
278,17,21,275.0,20.0,231,6415,1001,770
278,17,21,275.0,20.0,231,6415,1001,770
275,20,21,275.0,20.0,225,7495,1001,776
279,18,21,275.0,20.0,231,6777,1001,770
277,20,21,275.0,20.0,227,7497,1001,774
272,23,21,275.0,20.0,219,8575,1001,782
277,19,21,275.0,20.0,228,7136,1001,773
285,16,22,285.0,20.0,239,6061,377,138
280,22,22,285.0,20.0,228,8222,1001,773
280,23,22,285.0,20.0,227,8583,1001,774
289,16,22,285.0,20.0,243,6065,1001,758
286,23,22,285.0,20.0,233,8589,1001,768
284,19,22,285.0,20.0,235,7143,1001,766
288,21,22,285.0,20.0,237,7869,368,131
284,15,22,285.0,20.0,239,5699,409,170
280,24,22,285.0,20.0,226,8944,1001,775
281,20,22,285.0,20.0,231,7501,1001,770
299,15,23,295.0,20.0,254,5714,428,174
299,16,23,295.0,20.0,253,6075,422,169
296,18,23,295.0,20.0,248,6794,1001,753
293,15,23,295.0,20.0,248,5708,1001,753
296,18,23,295.0,20.0,248,6794,1001,753
294,23,23,295.0,20.0,241,8597,1001,760
296,23,23,295.0,20.0,243,8599,1001,758
293,23,23,295.0,20.0,240,8596,1001,761
297,20,23,295.0,20.0,247,7517,1001,754
298,22,23,295.0,20.0,246,8240,1001,755
309,16,24,305.0,20.0,263,6085,439,176
306,24,24,305.0,20.0,252,8970,1001,749
304,23,24,305.0,20.0,251,8607,1001,750
308,19,24,305.0,20.0,259,7167,1001,742
304,16,24,305.0,20.0,258,6080,1001,743
308,17,24,305.0,20.0,261,6445,432,171
304,24,24,305.0,20.0,250,8968,1001,751
309,21,24,305.0,20.0,258,7890,1001,743
306,18,24,305.0,20.0,258,6804,1001,743
304,15,24,305.0,20.0,259,5719,437,178
310,19,25,312.5,20.0,261,7169,1001,740
310,16,25,312.5,20.0,264,6086,441,177
310,19,25,312.5,20.0,261,7169,1001,740
313,15,25,312.5,20.0,268,5728,499,231
312,21,25,312.5,20.0,261,7893,1001,740
313,21,25,312.5,20.0,262,7894,1001,739
312,20,25,312.5,20.0,262,7532,461,199
312,20,25,312.5,20.0,262,7532,1001,739
311,19,25,312.5,20.0,262,7170,1001,739
311,22,25,312.5,20.0,259,8253,1001,742
64,34,26,65.0,30.0,8,12338,70,62
67,26,26,65.0,30.0,11,9453,43,32
62,30,26,65.0,30.0,2,10892,176,174
66,28,26,65.0,30.0,8,10174,29,21
66,25,26,65.0,30.0,11,9091,27,16
65,31,26,65.0,30.0,6,11256,38,32
61,30,26,65.0,30.0,1,10891,46,45
67,26,26,65.0,30.0,11,9453,34,23
68,28,26,65.0,30.0,10,10176,33,23
67,27,26,65.0,30.0,10,9814,48,38
72,32,27,75.0,30.0,14,11624,50,36
76,25,27,75.0,30.0,21,9101,60,39
77,27,27,75.0,30.0,20,9824,50,30
71,31,27,75.0,30.0,12,11262,65,53
73,33,27,75.0,30.0,16,11986,28,12
75,32,27,75.0,30.0,17,11627,62,45
75,26,27,75.0,30.0,19,9461,43,24
79,33,27,75.0,30.0,22,11992,35,13
77,31,27,75.0,30.0,18,11268,26,8
76,27,27,75.0,30.0,19,9823,51,32
84,25,28,85.0,30.0,29,9109,53,24
88,33,28,85.0,30.0,31,12001,41,10
85,32,28,85.0,30.0,27,11637,56,29
85,34,28,85.0,30.0,29,12359,42,13
89,34,28,85.0,30.0,33,12363,67,34
84,25,28,85.0,30.0,29,9109,61,32
83,30,28,85.0,30.0,23,10913,61,38
87,32,28,85.0,30.0,29,11639,51,22
87,30,28,85.0,30.0,27,10917,36,9
86,33,28,85.0,30.0,29,11999,58,29
97,30,29,95.0,30.0,37,10927,45,8
95,28,29,95.0,30.0,37,10203,168,131
91,33,29,95.0,30.0,34,12004,50,16
95,31,29,95.0,30.0,36,11286,44,8
98,28,29,95.0,30.0,40,10206,70,30
98,30,29,95.0,30.0,38,10928,76,38
98,25,29,95.0,30.0,43,9123,68,25
92,33,29,95.0,30.0,35,12005,63,28
97,30,29,95.0,30.0,37,10927,55,18
98,32,29,95.0,30.0,40,11650,59,19
106,26,30,105.0,30.0,50,9492,70,20
106,33,30,105.0,30.0,49,12019,89,40
109,31,30,105.0,30.0,50,11300,160,110
108,27,30,105.0,30.0,51,9855,78,27
106,26,30,105.0,30.0,50,9492,105,55
103,27,30,105.0,30.0,46,9850,75,29
104,28,30,105.0,30.0,46,10212,98,52
103,31,30,105.0,30.0,44,11294,51,7
109,28,30,105.0,30.0,51,10217,92,41
105,33,30,105.0,30.0,48,12018,90,42
113,33,31,115.0,30.0,56,12026,88,32
117,31,31,115.0,30.0,58,11308,145,87
111,32,31,115.0,30.0,53,11663,76,23
111,29,31,115.0,30.0,52,10580,74,22
110,33,31,115.0,30.0,53,12023,72,19
117,27,31,115.0,30.0,60,9864,93,33
119,27,31,115.0,30.0,62,9866,108,46
115,34,31,115.0,30.0,59,12389,80,21
111,32,31,115.0,30.0,53,11663,69,16
116,32,31,115.0,30.0,58,11668,87,29
127,32,32,125.0,30.0,69,11679,117,48
128,32,32,125.0,30.0,70,11680,118,48
123,28,32,125.0,30.0,65,10231,107,42
127,29,32,125.0,30.0,68,10596,109,41
120,32,32,125.0,30.0,62,11672,116,54
129,34,32,125.0,30.0,73,12403,126,53
126,31,32,125.0,30.0,67,11317,112,45
123,34,32,125.0,30.0,67,12397,109,42
127,27,32,125.0,30.0,70,9874,127,57
126,27,32,125.0,30.0,69,9873,179,110
131,31,33,135.0,30.0,72,11322,146,74
135,31,33,135.0,30.0,76,11326,144,68
130,28,33,135.0,30.0,72,10238,111,39
137,32,33,135.0,30.0,79,11689,112,33
139,27,33,135.0,30.0,82,9886,117,35
131,32,33,135.0,30.0,73,11683,110,37
134,34,33,135.0,30.0,78,12408,133,55
135,26,33,135.0,30.0,79,9521,114,35
135,27,33,135.0,30.0,78,9882,129,51
130,31,33,135.0,30.0,71,11321,140,69
148,30,34,145.0,30.0,88,10978,120,32
143,32,34,145.0,30.0,85,11695,150,65
148,34,34,145.0,30.0,92,12422,130,38
143,30,34,145.0,30.0,83,10973,120,37
146,30,34,145.0,30.0,86,10976,1001,915
141,25,34,145.0,30.0,86,9166,113,27
149,31,34,145.0,30.0,90,11340,172,82
145,31,34,145.0,30.0,86,11336,121,35
145,27,34,145.0,30.0,88,9892,129,41
149,34,34,145.0,30.0,93,12423,136,43
152,30,35,155.0,30.0,92,10982,164,72
157,34,35,155.0,30.0,101,12431,203,102
157,30,35,155.0,30.0,97,10987,145,48
157,25,35,155.0,30.0,102,9182,209,107
153,29,35,155.0,30.0,94,10622,161,67
154,33,35,155.0,30.0,97,12067,155,58
150,28,35,155.0,30.0,92,10258,148,56
150,28,35,155.0,30.0,92,10258,147,55
156,31,35,155.0,30.0,97,11347,162,65
155,31,35,155.0,30.0,96,11346,365,269
161,34,36,165.0,30.0,105,12435,135,30
162,28,36,165.0,30.0,104,10270,161,57
162,33,36,165.0,30.0,105,12075,152,47
163,33,36,165.0,30.0,106,12076,1001,895
160,33,36,165.0,30.0,103,12073,1001,898
164,34,36,165.0,30.0,108,12438,152,44
166,32,36,165.0,30.0,108,11718,133,25
164,30,36,165.0,30.0,104,10994,155,51
167,30,36,165.0,30.0,107,10997,161,54
167,29,36,165.0,30.0,108,10636,175,67
171,32,37,175.0,30.0,113,11723,152,39
171,28,37,175.0,30.0,113,10279,187,74
175,26,37,175.0,30.0,119,9561,1001,882
176,28,37,175.0,30.0,118,10284,1001,883
172,28,37,175.0,30.0,114,10280,165,51
174,26,37,175.0,30.0,118,9560,200,82
171,25,37,175.0,30.0,116,9196,1001,885
177,26,37,175.0,30.0,121,9563,158,37
173,28,37,175.0,30.0,115,10281,151,36
171,28,37,175.0,30.0,113,10279,177,64
184,33,38,185.0,30.0,127,12097,1001,874
184,32,38,185.0,30.0,126,11736,1001,875
189,32,38,185.0,30.0,131,11741,1001,870
186,31,38,185.0,30.0,127,11377,1001,874
188,33,38,185.0,30.0,131,12101,1001,870
184,33,38,185.0,30.0,127,12097,1001,874
184,26,38,185.0,30.0,128,9570,1001,873
180,28,38,185.0,30.0,122,10288,180,58
189,29,38,185.0,30.0,130,10658,1001,871
184,30,38,185.0,30.0,124,11014,1001,877
191,32,39,195.0,30.0,133,11743,1001,868
195,32,39,195.0,30.0,137,11747,1001,864
192,26,39,195.0,30.0,136,9578,1001,865
197,31,39,195.0,30.0,138,11388,1001,863
197,25,39,195.0,30.0,142,9222,1001,859
191,34,39,195.0,30.0,135,12465,1001,866
197,25,39,195.0,30.0,142,9222,1001,859
193,26,39,195.0,30.0,137,9579,1001,864
190,27,39,195.0,30.0,133,9937,1001,868
193,25,39,195.0,30.0,138,9218,1001,863
208,28,40,205.0,30.0,150,10316,1001,851
205,30,40,205.0,30.0,145,11035,1001,856
207,34,40,205.0,30.0,151,12481,1001,850
204,27,40,205.0,30.0,147,9951,1001,854
207,28,40,205.0,30.0,149,10315,1001,852
203,31,40,205.0,30.0,144,11394,1001,857
209,27,40,205.0,30.0,152,9956,1001,849
207,34,40,205.0,30.0,151,12481,1001,850
205,27,40,205.0,30.0,148,9952,1001,853
207,29,40,205.0,30.0,148,10676,1001,853
212,32,41,215.0,30.0,154,11764,1001,847
217,33,41,215.0,30.0,160,12130,1001,841
214,34,41,215.0,30.0,158,12488,1001,843
213,29,41,215.0,30.0,154,10682,1001,847
219,26,41,215.0,30.0,163,9605,1001,838
211,30,41,215.0,30.0,151,11041,1001,850
219,29,41,215.0,30.0,160,10688,1001,841
212,26,41,215.0,30.0,156,9598,1001,845
215,26,41,215.0,30.0,159,9601,1001,842
210,32,41,215.0,30.0,152,11762,1001,849
224,28,42,225.0,30.0,166,10332,1001,835
224,30,42,225.0,30.0,164,11054,1001,837
225,26,42,225.0,30.0,169,9611,1001,832
228,33,42,225.0,30.0,171,12141,1001,830
223,27,42,225.0,30.0,166,9970,1001,835
221,33,42,225.0,30.0,164,12134,1001,837
229,28,42,225.0,30.0,171,10337,1001,830
223,25,42,225.0,30.0,168,9248,291,123
221,33,42,225.0,30.0,164,12134,1001,837
225,26,42,225.0,30.0,169,9611,337,168
234,32,43,235.0,30.0,176,11786,1001,825
234,32,43,235.0,30.0,176,11786,1001,825
233,28,43,235.0,30.0,175,10341,1001,826
234,26,43,235.0,30.0,178,9620,1001,823
239,34,43,235.0,30.0,183,12513,357,174
234,32,43,235.0,30.0,176,11786,1001,825
237,29,43,235.0,30.0,178,10706,1001,823
230,30,43,235.0,30.0,170,11060,1001,831
232,27,43,235.0,30.0,175,9979,1001,826
238,27,43,235.0,30.0,181,9985,1001,820
245,30,44,245.0,30.0,185,11075,1001,816
245,31,44,245.0,30.0,186,11436,1001,815
241,28,44,245.0,30.0,183,10349,1001,818
249,25,44,245.0,30.0,194,9274,1001,807
240,29,44,245.0,30.0,181,10709,1001,820
249,30,44,245.0,30.0,189,11079,1001,812
245,31,44,245.0,30.0,186,11436,1001,815
248,31,44,245.0,30.0,189,11439,1001,812
244,28,44,245.0,30.0,186,10352,1001,815
243,34,44,245.0,30.0,187,12517,1001,814
253,27,45,255.0,30.0,196,10000,1001,805
258,31,45,255.0,30.0,199,11449,1001,802
255,31,45,255.0,30.0,196,11446,327,131
253,28,45,255.0,30.0,195,10361,1001,806
256,31,45,255.0,30.0,197,11447,366,169
250,33,45,255.0,30.0,193,12163,1001,808
253,33,45,255.0,30.0,196,12166,1001,805
251,34,45,255.0,30.0,195,12525,1001,806
251,25,45,255.0,30.0,196,9276,1001,805
250,29,45,255.0,30.0,191,10719,337,146
267,27,46,265.0,30.0,210,10014,348,138
261,27,46,265.0,30.0,204,10008,1001,797
262,30,46,265.0,30.0,202,11092,1001,799
266,25,46,265.0,30.0,211,9291,1001,790
262,30,46,265.0,30.0,202,11092,363,161
262,33,46,265.0,30.0,205,12175,1001,796
260,33,46,265.0,30.0,203,12173,1001,798
264,34,46,265.0,30.0,208,12538,1001,793
262,26,46,265.0,30.0,206,9648,1001,795
262,25,46,265.0,30.0,207,9287,1001,794
273,28,47,275.0,30.0,215,10381,354,139
270,34,47,275.0,30.0,214,12544,371,157
271,34,47,275.0,30.0,215,12545,379,164
276,26,47,275.0,30.0,220,9662,357,137
272,34,47,275.0,30.0,216,12546,416,200
270,28,47,275.0,30.0,212,10378,383,171
277,30,47,275.0,30.0,217,11107,1001,784
278,34,47,275.0,30.0,222,12552,392,170
272,26,47,275.0,30.0,216,9658,1001,785
270,30,47,275.0,30.0,210,11100,1001,791
281,25,48,285.0,30.0,226,9306,372,146
287,27,48,285.0,30.0,230,10034,379,149
281,30,48,285.0,30.0,221,11111,1001,780
284,27,48,285.0,30.0,227,10031,1001,774
280,25,48,285.0,30.0,225,9305,387,162
283,33,48,285.0,30.0,226,12196,427,201
283,30,48,285.0,30.0,223,11113,394,171
281,28,48,285.0,30.0,223,10389,357,134
289,28,48,285.0,30.0,231,10397,1001,770
285,30,48,285.0,30.0,225,11115,403,178
290,25,49,295.0,30.0,235,9315,1001,766
299,30,49,295.0,30.0,239,11129,1001,762
294,30,49,295.0,30.0,234,11124,407,173
291,28,49,295.0,30.0,233,10399,360,127
294,28,49,295.0,30.0,236,10402,396,160
293,29,49,295.0,30.0,234,10762,1001,767
290,31,49,295.0,30.0,231,11481,401,170
297,33,49,295.0,30.0,240,12210,1001,761
292,33,49,295.0,30.0,235,12205,386,151
296,31,49,295.0,30.0,237,11487,393,156
303,34,50,305.0,30.0,247,12577,1001,754
304,28,50,305.0,30.0,246,10412,1001,755
307,28,50,305.0,30.0,249,10415,1001,752
301,30,50,305.0,30.0,241,11131,1001,760
307,33,50,305.0,30.0,250,12220,1001,751
302,30,50,305.0,30.0,242,11132,1001,759
300,31,50,305.0,30.0,241,11491,1001,760
300,30,50,305.0,30.0,240,11130,1001,761
306,34,50,305.0,30.0,250,12580,1001,751
300,27,50,305.0,30.0,243,10047,1001,758
312,32,51,312.5,30.0,254,11864,1001,747
310,27,51,312.5,30.0,253,10057,1001,748
313,29,51,312.5,30.0,254,10782,1001,747
311,26,51,312.5,30.0,255,9697,1001,746
310,32,51,312.5,30.0,252,11862,1001,749
313,34,51,312.5,30.0,257,12587,1001,744
314,29,51,312.5,30.0,255,10783,434,179
314,27,51,312.5,30.0,257,10061,1001,744
312,28,51,312.5,30.0,254,10420,1001,747
313,34,51,312.5,30.0,257,12587,1001,744
68,36,52,65.0,40.0,14,13064,26,12
62,43,52,65.0,40.0,15,15585,56,41
68,35,52,65.0,40.0,13,12703,45,32
63,39,52,65.0,40.0,12,14142,55,43
66,43,52,65.0,40.0,19,15589,62,43
62,38,52,65.0,40.0,10,13780,45,35
64,37,52,65.0,40.0,11,13421,34,23
60,39,52,65.0,40.0,9,14139,40,31
61,43,52,65.0,40.0,14,15584,55,41
66,35,52,65.0,40.0,11,12701,17,6
71,42,53,75.0,40.0,23,15233,90,67
73,44,53,75.0,40.0,27,15957,101,74
70,41,53,75.0,40.0,21,14871,102,81
73,38,53,75.0,40.0,21,13791,26,5
74,40,53,75.0,40.0,24,14514,83,59
71,38,53,75.0,40.0,19,13789,26,7
70,37,53,75.0,40.0,17,13427,37,20
74,44,53,75.0,40.0,28,15958,88,60
78,41,53,75.0,40.0,29,14879,77,48
74,37,53,75.0,40.0,21,13431,51,30
83,35,54,85.0,40.0,28,12718,45,17
88,35,54,85.0,40.0,33,12723,51,18
83,40,54,85.0,40.0,33,14523,63,30
81,44,54,85.0,40.0,35,15965,87,52
80,37,54,85.0,40.0,27,13437,47,20
84,35,54,85.0,40.0,29,12719,56,27
87,38,54,85.0,40.0,35,13805,58,23
86,40,54,85.0,40.0,36,14526,60,24
89,43,54,85.0,40.0,42,15612,86,44
83,44,54,85.0,40.0,37,15967,86,49
91,42,55,95.0,40.0,43,15253,101,58
99,35,55,95.0,40.0,44,12734,57,13
97,37,55,95.0,40.0,44,13454,91,47
93,40,55,95.0,40.0,43,14533,51,8
99,39,55,95.0,40.0,48,14178,69,21
93,43,55,95.0,40.0,46,15616,100,54
94,35,55,95.0,40.0,39,12729,53,14
94,35,55,95.0,40.0,39,12729,45,6
97,37,55,95.0,40.0,44,13454,61,17
91,36,55,95.0,40.0,37,13087,58,21
107,40,56,105.0,40.0,57,14547,77,20
103,38,56,105.0,40.0,51,13821,78,27
100,40,56,105.0,40.0,50,14540,58,8
103,39,56,105.0,40.0,52,14182,74,22
100,42,56,105.0,40.0,52,15262,94,42
107,44,56,105.0,40.0,61,15991,122,61
108,41,56,105.0,40.0,59,14909,111,52
106,37,56,105.0,40.0,53,13463,78,25
101,35,56,105.0,40.0,46,12736,77,31
106,43,56,105.0,40.0,59,15629,125,66
117,35,57,115.0,40.0,62,12752,111,49
114,39,57,115.0,40.0,63,14193,92,29
114,40,57,115.0,40.0,64,14554,109,45
111,44,57,115.0,40.0,65,15995,128,63
116,41,57,115.0,40.0,67,14917,106,39
114,42,57,115.0,40.0,66,15276,122,56
118,36,57,115.0,40.0,64,13114,76,12
114,41,57,115.0,40.0,65,14915,90,25
115,40,57,115.0,40.0,65,14555,100,35
110,35,57,115.0,40.0,55,12745,74,19
124,37,58,125.0,40.0,71,13481,93,22
127,35,58,125.0,40.0,72,12762,106,34
128,39,58,125.0,40.0,77,14207,144,67
122,37,58,125.0,40.0,69,13479,109,40
125,36,58,125.0,40.0,71,13121,102,31
125,42,58,125.0,40.0,77,15287,148,71
129,44,58,125.0,40.0,83,16013,159,76
129,43,58,125.0,40.0,82,15652,194,112
122,42,58,125.0,40.0,74,15284,1001,927
125,40,58,125.0,40.0,75,14565,92,17
133,37,59,135.0,40.0,80,13490,99,19
138,38,59,135.0,40.0,86,13856,127,41
134,39,59,135.0,40.0,83,14213,112,29
134,35,59,135.0,40.0,79,12769,125,46
139,42,59,135.0,40.0,91,15301,114,23
137,36,59,135.0,40.0,83,13133,121,38
134,36,59,135.0,40.0,80,13130,122,42
136,40,59,135.0,40.0,86,14576,144,58
135,41,59,135.0,40.0,86,14936,176,90
139,43,59,135.0,40.0,92,15662,119,27
147,44,60,145.0,40.0,101,16031,156,55
143,37,60,145.0,40.0,90,13500,120,30
146,38,60,145.0,40.0,94,13864,122,28
141,39,60,145.0,40.0,90,14220,154,64
145,36,60,145.0,40.0,91,13141,113,22
146,37,60,145.0,40.0,93,13503,111,18
145,43,60,145.0,40.0,98,15668,166,68
141,36,60,145.0,40.0,87,13137,116,29
142,42,60,145.0,40.0,94,15304,125,31
146,35,60,145.0,40.0,91,12781,126,35
156,35,61,155.0,40.0,101,12791,133,32
151,38,61,155.0,40.0,99,13869,107,8
152,37,61,155.0,40.0,99,13509,119,20
156,35,61,155.0,40.0,101,12791,140,39
151,36,61,155.0,40.0,97,13147,137,40
150,35,61,155.0,40.0,95,12785,121,26
157,41,61,155.0,40.0,108,14958,138,30
152,39,61,155.0,40.0,101,14231,127,26
154,42,61,155.0,40.0,106,15316,176,70
150,38,61,155.0,40.0,98,13868,138,40
164,35,62,165.0,40.0,109,12799,142,33
169,35,62,165.0,40.0,114,12804,1001,887
169,43,62,165.0,40.0,122,15692,248,126
164,39,62,165.0,40.0,113,14243,228,115
163,41,62,165.0,40.0,114,14964,1001,887
166,36,62,165.0,40.0,112,13162,134,22
165,36,62,165.0,40.0,111,13161,250,139
166,43,62,165.0,40.0,119,15689,212,93
166,39,62,165.0,40.0,115,14245,135,20
161,42,62,165.0,40.0,113,15323,174,61
179,37,63,175.0,40.0,126,13536,151,25
177,39,63,175.0,40.0,126,14256,188,62
174,44,63,175.0,40.0,128,16058,204,76
172,40,63,175.0,40.0,122,14612,1001,879
176,41,63,175.0,40.0,127,14977,162,35
171,43,63,175.0,40.0,124,15694,219,95
179,43,63,175.0,40.0,132,15702,203,71
176,40,63,175.0,40.0,126,14616,185,59
177,40,63,175.0,40.0,127,14617,157,30
177,39,63,175.0,40.0,126,14256,244,118
189,37,64,185.0,40.0,136,13546,1001,865
187,36,64,185.0,40.0,133,13183,1001,868
188,39,64,185.0,40.0,137,14267,1001,864
182,36,64,185.0,40.0,128,13178,1001,873
183,40,64,185.0,40.0,133,14623,1001,868
180,44,64,185.0,40.0,134,16064,234,100
189,39,64,185.0,40.0,138,14268,1001,863
184,38,64,185.0,40.0,132,13902,1001,869
189,37,64,185.0,40.0,136,13546,1001,865
182,43,64,185.0,40.0,135,15705,1001,866
193,38,65,195.0,40.0,141,13911,1001,860
191,43,65,195.0,40.0,144,15714,1001,857
195,38,65,195.0,40.0,143,13913,1001,858
195,37,65,195.0,40.0,142,13552,1001,859
195,41,65,195.0,40.0,146,14996,1001,855
192,42,65,195.0,40.0,144,15354,1001,857
199,36,65,195.0,40.0,145,13195,1001,856
199,39,65,195.0,40.0,148,14278,1001,853
199,35,65,195.0,40.0,144,12834,1001,857
198,40,65,195.0,40.0,148,14638,1001,853
206,37,66,205.0,40.0,153,13563,1001,848
207,35,66,205.0,40.0,152,12842,1001,849
201,37,66,205.0,40.0,148,13558,1001,853
206,42,66,205.0,40.0,158,15368,1001,843
209,35,66,205.0,40.0,154,12844,1001,847
205,44,66,205.0,40.0,159,16089,1001,842
204,40,66,205.0,40.0,154,14644,1001,847
206,35,66,205.0,40.0,151,12841,1001,850
204,38,66,205.0,40.0,152,13922,1001,849
209,36,66,205.0,40.0,155,13205,1001,846
211,35,67,215.0,40.0,156,12846,1001,845
212,42,67,215.0,40.0,164,15374,1001,837
214,35,67,215.0,40.0,159,12849,1001,842
214,37,67,215.0,40.0,161,13571,1001,840
213,43,67,215.0,40.0,166,15736,1001,835
213,36,67,215.0,40.0,159,13209,1001,842
211,43,67,215.0,40.0,164,15734,1001,837
217,44,67,215.0,40.0,171,16101,1001,830
218,37,67,215.0,40.0,165,13575,1001,836
213,36,67,215.0,40.0,159,13209,1001,842
220,44,68,225.0,40.0,174,16104,1001,827
227,39,68,225.0,40.0,176,14306,1001,825
221,39,68,225.0,40.0,170,14300,1001,831
222,36,68,225.0,40.0,168,13218,1001,833
226,44,68,225.0,40.0,180,16110,1001,821
229,36,68,225.0,40.0,175,13225,1001,826
221,37,68,225.0,40.0,168,13578,1001,833
228,36,68,225.0,40.0,174,13224,1001,827
220,41,68,225.0,40.0,171,15021,1001,830
222,43,68,225.0,40.0,175,15745,1001,826
233,37,69,235.0,40.0,180,13590,1001,821
235,35,69,235.0,40.0,180,12870,1001,821
233,44,69,235.0,40.0,187,16117,1001,814
233,39,69,235.0,40.0,182,14312,1001,819
238,35,69,235.0,40.0,183,12873,1001,818
239,39,69,235.0,40.0,188,14318,1001,813
231,38,69,235.0,40.0,179,13949,1001,822
230,40,69,235.0,40.0,180,14670,1001,821
239,43,69,235.0,40.0,192,15762,1001,809
233,42,69,235.0,40.0,185,15395,1001,816
243,39,70,245.0,40.0,192,14322,1001,809
248,40,70,245.0,40.0,198,14688,1001,803
245,35,70,245.0,40.0,190,12880,1001,811
246,35,70,245.0,40.0,191,12881,1001,810
246,43,70,245.0,40.0,199,15769,1001,802
247,37,70,245.0,40.0,194,13604,1001,807
242,40,70,245.0,40.0,192,14682,1001,809
246,40,70,245.0,40.0,196,14686,1001,805
245,37,70,245.0,40.0,192,13602,1001,809
242,37,70,245.0,40.0,189,13599,1001,812
253,39,71,255.0,40.0,202,14332,1001,799
256,35,71,255.0,40.0,201,12891,1001,800
253,36,71,255.0,40.0,199,13249,357,158
251,42,71,255.0,40.0,203,15413,1001,798
259,38,71,255.0,40.0,207,13977,1001,794
255,38,71,255.0,40.0,203,13973,1001,798
253,38,71,255.0,40.0,201,13971,1001,800
256,37,71,255.0,40.0,203,13613,1001,798
253,38,71,255.0,40.0,201,13971,1001,800
252,44,71,255.0,40.0,206,16136,1001,795
269,35,72,265.0,40.0,214,12904,354,140
268,36,72,265.0,40.0,214,13264,409,195
265,40,72,265.0,40.0,215,14705,374,159
267,36,72,265.0,40.0,213,13263,371,158
262,44,72,265.0,40.0,216,16146,1001,785
261,44,72,265.0,40.0,215,16145,1001,786
260,38,72,265.0,40.0,208,13978,362,154
267,44,72,265.0,40.0,221,16151,368,147
262,39,72,265.0,40.0,211,14341,1001,790
264,39,72,265.0,40.0,213,14343,382,169
271,40,73,275.0,40.0,221,14711,380,159
277,44,73,275.0,40.0,231,16161,395,164
279,37,73,275.0,40.0,226,13636,379,153
279,35,73,275.0,40.0,224,12914,371,147
270,38,73,275.0,40.0,218,13988,366,148
272,35,73,275.0,40.0,217,12907,376,159
279,43,73,275.0,40.0,232,15802,401,169
275,40,73,275.0,40.0,225,14715,386,161
278,35,73,275.0,40.0,223,12913,393,170
274,42,73,275.0,40.0,226,15436,375,149
280,39,74,285.0,40.0,229,14359,401,172
281,38,74,285.0,40.0,229,13999,398,169
282,42,74,285.0,40.0,234,15444,391,157
282,40,74,285.0,40.0,232,14722,388,156
287,39,74,285.0,40.0,236,14366,394,158
281,43,74,285.0,40.0,234,15804,388,154
283,39,74,285.0,40.0,232,14362,381,149
281,43,74,285.0,40.0,234,15804,384,150
287,39,74,285.0,40.0,236,14366,449,213
286,39,74,285.0,40.0,235,14365,1001,766
293,35,75,295.0,40.0,238,12928,394,156
293,44,75,295.0,40.0,247,16177,408,161
299,36,75,295.0,40.0,245,13295,1001,756
295,35,75,295.0,40.0,240,12930,408,168
291,35,75,295.0,40.0,236,12926,381,145
298,41,75,295.0,40.0,249,15099,406,157
293,42,75,295.0,40.0,245,15455,424,179
293,44,75,295.0,40.0,247,16177,407,160
295,37,75,295.0,40.0,242,13652,1001,759
291,37,75,295.0,40.0,238,13648,400,162
308,35,76,305.0,40.0,253,12943,1001,748
301,43,76,305.0,40.0,254,15824,1001,747
308,44,76,305.0,40.0,262,16192,435,173
302,36,76,305.0,40.0,248,13298,1001,753
304,40,76,305.0,40.0,254,14744,1001,747
303,35,76,305.0,40.0,248,12938,1001,753
303,40,76,305.0,40.0,253,14743,1001,748
303,37,76,305.0,40.0,250,13660,1001,751
307,39,76,305.0,40.0,256,14386,1001,745
308,36,76,305.0,40.0,254,13304,1001,747
314,38,77,312.5,40.0,262,14032,1001,739
314,40,77,312.5,40.0,264,14754,1001,737
312,36,77,312.5,40.0,258,13308,426,168
311,42,77,312.5,40.0,263,15473,426,163
314,38,77,312.5,40.0,262,14032,1001,739
312,36,77,312.5,40.0,258,13308,1001,743
311,40,77,312.5,40.0,261,14751,1001,740
312,42,77,312.5,40.0,264,15474,1001,737
313,40,77,312.5,40.0,263,14753,1001,738
312,35,77,312.5,40.0,257,12947,1001,744
