x,y,cell,cell_x,cell_y,opt_traj,point_id,steps_taken,extra_steps
62,18,0,65.0,20.0,14,6560,387,373
63,23,0,65.0,20.0,10,8366,165,155
64,16,0,65.0,20.0,18,5840,76,58
61,20,0,65.0,20.0,11,7281,27,16
63,21,0,65.0,20.0,12,7644,79,67
65,17,0,65.0,20.0,18,6202,104,86
65,21,0,65.0,20.0,14,7646,45,31
65,15,0,65.0,20.0,20,5480,104,84
69,24,0,65.0,20.0,15,8733,29,14
66,15,0,65.0,20.0,21,5481,47,26
79,23,1,75.0,20.0,26,8382,79,53
75,15,1,75.0,20.0,30,5490,64,34
71,17,1,75.0,20.0,24,6208,51,27
72,17,1,75.0,20.0,25,6209,64,39
79,24,1,75.0,20.0,25,8743,39,14
77,21,1,75.0,20.0,26,7658,85,59
75,19,1,75.0,20.0,26,6934,41,15
78,23,1,75.0,20.0,25,8381,1001,976
74,24,1,75.0,20.0,20,8738,94,74
79,22,1,75.0,20.0,27,8021,48,21
88,18,2,85.0,20.0,40,6586,70,30
88,21,2,85.0,20.0,37,7669,69,32
80,23,2,85.0,20.0,27,8383,60,33
89,20,2,85.0,20.0,39,7309,58,19
86,21,2,85.0,20.0,35,7667,86,51
89,22,2,85.0,20.0,37,8031,64,27
80,17,2,85.0,20.0,33,6217,76,43
80,17,2,85.0,20.0,33,6217,66,33
82,16,2,85.0,20.0,36,5858,57,21
89,19,2,85.0,20.0,40,6948,64,24
91,20,3,95.0,20.0,41,7311,80,39
92,19,3,95.0,20.0,43,6951,69,26
98,17,3,95.0,20.0,51,6235,70,19
98,20,3,95.0,20.0,48,7318,68,20
99,24,3,95.0,20.0,45,8763,64,19
92,20,3,95.0,20.0,42,7312,129,87
96,22,3,95.0,20.0,44,8038,94,50
91,24,3,95.0,20.0,37,8755,63,26
94,19,3,95.0,20.0,45,6953,109,64
92,18,3,95.0,20.0,44,6590,63,19
108,22,4,105.0,20.0,56,8050,82,26
105,18,4,105.0,20.0,57,6603,82,25
109,15,4,105.0,20.0,64,5524,93,29
104,17,4,105.0,20.0,57,6241,84,27
102,18,4,105.0,20.0,54,6600,81,27
104,22,4,105.0,20.0,52,8046,104,52
109,17,4,105.0,20.0,62,6246,85,23
104,18,4,105.0,20.0,56,6602,116,60
100,22,4,105.0,20.0,48,8042,82,34
105,22,4,105.0,20.0,53,8047,84,31
113,16,5,115.0,20.0,67,5889,98,31
115,17,5,115.0,20.0,68,6252,111,43
113,20,5,115.0,20.0,63,7333,126,63
116,17,5,115.0,20.0,69,6253,91,22
110,24,5,115.0,20.0,56,8774,87,31
110,22,5,115.0,20.0,58,8052,121,63
110,17,5,115.0,20.0,63,6247,116,53
114,16,5,115.0,20.0,68,5890,130,62
113,22,5,115.0,20.0,61,8055,130,69
115,15,5,115.0,20.0,70,5530,123,53
123,23,6,125.0,20.0,70,8426,103,33
125,24,6,125.0,20.0,71,8789,111,40
123,20,6,125.0,20.0,73,7343,116,43
121,23,6,125.0,20.0,68,8424,87,19
125,24,6,125.0,20.0,71,8789,127,56
121,18,6,125.0,20.0,73,6619,99,26
125,22,6,125.0,20.0,73,8067,103,30
129,19,6,125.0,20.0,80,6988,107,27
120,23,6,125.0,20.0,67,8423,110,43
125,18,6,125.0,20.0,77,6623,1001,924
134,23,7,135.0,20.0,81,8437,130,49
132,21,7,135.0,20.0,81,7713,110,29
130,18,7,135.0,20.0,82,6628,108,26
136,19,7,135.0,20.0,87,6995,118,31
133,17,7,135.0,20.0,86,6270,130,44
138,21,7,135.0,20.0,87,7719,158,71
134,15,7,135.0,20.0,89,5549,117,28
135,19,7,135.0,20.0,86,6994,105,19
139,17,7,135.0,20.0,92,6276,124,32
132,20,7,135.0,20.0,82,7352,103,21
142,15,8,145.0,20.0,97,5557,169,72
143,23,8,145.0,20.0,90,8446,152,62
143,21,8,145.0,20.0,92,7724,127,35
141,21,8,145.0,20.0,90,7722,205,115
146,15,8,145.0,20.0,101,5561,157,56
143,21,8,145.0,20.0,92,7724,116,24
146,24,8,145.0,20.0,92,8810,114,22
142,23,8,145.0,20.0,89,8445,205,116
144,24,8,145.0,20.0,90,8808,118,28
144,15,8,145.0,20.0,99,5559,183,84
153,15,9,155.0,20.0,108,5568,196,88
155,19,9,155.0,20.0,106,7014,147,41
156,23,9,155.0,20.0,103,8459,141,38
157,15,9,155.0,20.0,112,5572,201,89
158,18,9,155.0,20.0,110,6656,137,27
152,17,9,155.0,20.0,105,6289,201,96
150,17,9,155.0,20.0,103,6287,145,42
155,18,9,155.0,20.0,107,6653,146,39
156,24,9,155.0,20.0,102,8820,179,77
159,17,9,155.0,20.0,112,6296,161,49
169,24,10,165.0,20.0,115,8833,177,62
164,24,10,165.0,20.0,110,8828,179,69
166,21,10,165.0,20.0,115,7747,144,29
165,22,10,165.0,20.0,113,8107,147,34
166,23,10,165.0,20.0,113,8469,222,109
164,17,10,165.0,20.0,117,6301,215,98
161,17,10,165.0,20.0,114,6298,141,27
166,17,10,165.0,20.0,119,6303,156,37
165,16,10,165.0,20.0,119,5941,172,53
164,17,10,165.0,20.0,117,6301,159,42
178,16,11,175.0,20.0,132,5954,221,89
171,20,11,175.0,20.0,121,7391,175,54
178,23,11,175.0,20.0,125,8481,164,39
179,22,11,175.0,20.0,127,8121,169,42
171,18,11,175.0,20.0,123,6669,180,57
176,21,11,175.0,20.0,125,7757,156,31
174,24,11,175.0,20.0,120,8838,156,36
173,15,11,175.0,20.0,128,5588,175,47
178,24,11,175.0,20.0,124,8842,161,37
172,20,11,175.0,20.0,122,7392,269,147
182,15,12,185.0,20.0,137,5597,222,85
188,24,12,185.0,20.0,134,8852,1001,867
184,20,12,185.0,20.0,134,7404,1001,867
181,17,12,185.0,20.0,134,6318,234,100
182,17,12,185.0,20.0,135,6319,1001,866
184,20,12,185.0,20.0,134,7404,239,105
189,17,12,185.0,20.0,142,6326,1001,859
183,19,12,185.0,20.0,134,7042,1001,867
187,23,12,185.0,20.0,134,8490,1001,867
185,24,12,185.0,20.0,131,8849,1001,870
197,18,13,195.0,20.0,149,6695,256,107
193,23,13,195.0,20.0,140,8496,261,121
198,21,13,195.0,20.0,147,7779,301,154
198,18,13,195.0,20.0,150,6696,1001,851
196,15,13,195.0,20.0,151,5611,246,95
196,18,13,195.0,20.0,148,6694,271,123
194,21,13,195.0,20.0,143,7775,262,119
196,23,13,195.0,20.0,143,8499,257,114
197,16,13,195.0,20.0,151,5973,237,86
190,23,13,195.0,20.0,137,8493,249,112
203,15,14,205.0,20.0,158,5618,260,102
205,16,14,205.0,20.0,159,5981,255,96
202,19,14,205.0,20.0,153,7061,262,109
208,23,14,205.0,20.0,155,8511,310,155
207,23,14,205.0,20.0,154,8510,280,126
205,20,14,205.0,20.0,155,7425,324,169
206,22,14,205.0,20.0,154,8148,295,141
203,18,14,205.0,20.0,155,6701,263,108
207,16,14,205.0,20.0,161,5983,262,101
208,22,14,205.0,20.0,156,8150,265,109
216,22,15,215.0,20.0,164,8158,272,108
214,23,15,215.0,20.0,161,8517,271,110
218,23,15,215.0,20.0,165,8521,281,116
210,24,15,215.0,20.0,156,8874,288,132
215,17,15,215.0,20.0,168,6352,270,102
218,24,15,215.0,20.0,164,8882,289,125
213,15,15,215.0,20.0,168,5628,279,111
213,19,15,215.0,20.0,164,7072,270,106
218,22,15,215.0,20.0,166,8160,293,127
218,17,15,215.0,20.0,171,6355,275,104
225,20,16,225.0,20.0,175,7445,300,125
225,18,16,225.0,20.0,177,6723,273,96
225,21,16,225.0,20.0,174,7806,287,113
226,18,16,225.0,20.0,178,6724,284,106
222,23,16,225.0,20.0,169,8525,303,134
227,23,16,225.0,20.0,174,8530,1001,827
228,20,16,225.0,20.0,178,7448,1001,823
225,24,16,225.0,20.0,171,8889,291,120
228,23,16,225.0,20.0,175,8531,304,129
220,24,16,225.0,20.0,166,8884,328,162
239,20,17,235.0,20.0,189,7459,305,116
238,24,17,235.0,20.0,184,8902,1001,817
239,15,17,235.0,20.0,194,5654,409,215
237,15,17,235.0,20.0,192,5652,311,119
238,18,17,235.0,20.0,190,6736,1001,811
236,20,17,235.0,20.0,186,7456,1001,815
234,20,17,235.0,20.0,184,7454,1001,817
237,15,17,235.0,20.0,192,5652,411,219
236,17,17,235.0,20.0,189,6373,1001,812
230,16,17,235.0,20.0,184,6006,1001,817
240,17,18,245.0,20.0,193,6377,402,209
247,15,18,245.0,20.0,202,5662,408,206
248,16,18,245.0,20.0,202,6024,405,203
246,18,18,245.0,20.0,198,6744,328,130
240,15,18,245.0,20.0,195,5655,391,196
241,16,18,245.0,20.0,195,6017,355,160
249,19,18,245.0,20.0,200,7108,319,119
246,18,18,245.0,20.0,198,6744,410,212
247,24,18,245.0,20.0,193,8911,310,117
240,16,18,245.0,20.0,194,6016,341,147
259,20,19,255.0,20.0,209,7479,405,196
258,23,19,255.0,20.0,205,8561,330,125
258,23,19,255.0,20.0,205,8561,325,120
252,20,19,255.0,20.0,202,7472,332,130
258,21,19,255.0,20.0,207,7839,351,144
252,23,19,255.0,20.0,199,8555,311,112
259,21,19,255.0,20.0,208,7840,334,126
256,20,19,255.0,20.0,206,7476,334,128
257,16,19,255.0,20.0,211,6033,331,120
250,24,19,255.0,20.0,196,8914,311,115
265,17,20,265.0,20.0,218,6402,388,170
267,19,20,265.0,20.0,218,7126,358,140
266,18,20,265.0,20.0,218,6764,418,200
261,17,20,265.0,20.0,214,6398,398,184
263,15,20,265.0,20.0,218,5678,400,182
263,17,20,265.0,20.0,216,6400,403,187
262,18,20,265.0,20.0,214,6760,425,211
261,15,20,265.0,20.0,216,5676,388,172
269,24,20,265.0,20.0,215,8933,338,123
263,19,20,265.0,20.0,214,7122,356,142
278,18,21,275.0,20.0,230,6776,390,160
274,24,21,275.0,20.0,220,8938,352,132
273,24,21,275.0,20.0,219,8937,352,133
278,16,21,275.0,20.0,232,6054,419,187
278,18,21,275.0,20.0,230,6776,398,168
275,18,21,275.0,20.0,227,6773,364,137
278,20,21,275.0,20.0,228,7498,378,150
274,15,21,275.0,20.0,229,5689,415,186
271,18,21,275.0,20.0,223,6769,535,312
277,17,21,275.0,20.0,230,6414,391,161
286,19,22,285.0,20.0,237,7145,373,136
283,23,22,285.0,20.0,230,8586,372,142
289,17,22,285.0,20.0,242,6426,392,150
287,18,22,285.0,20.0,239,6785,364,125
283,19,22,285.0,20.0,234,7142,403,169
281,17,22,285.0,20.0,234,6418,409,175
289,20,22,285.0,20.0,239,7509,401,162
283,23,22,285.0,20.0,230,8586,354,124
285,22,22,285.0,20.0,233,8227,420,187
289,22,22,285.0,20.0,237,8231,372,135
292,15,23,295.0,20.0,247,5707,428,181
299,21,23,295.0,20.0,248,7880,417,169
290,18,23,295.0,20.0,242,6788,415,173
296,22,23,295.0,20.0,244,8238,419,175
293,17,23,295.0,20.0,246,6430,417,171
297,22,23,295.0,20.0,245,8239,372,127
294,24,23,295.0,20.0,240,8958,1001,761
293,18,23,295.0,20.0,245,6791,412,167
292,24,23,295.0,20.0,238,8956,376,138
295,20,23,295.0,20.0,245,7515,385,140
304,17,24,305.0,20.0,257,6441,426,169
303,21,24,305.0,20.0,252,7884,409,157
302,19,24,305.0,20.0,253,7161,415,162
303,18,24,305.0,20.0,255,6801,1001,746
300,17,24,305.0,20.0,253,6437,433,180
307,23,24,305.0,20.0,254,8610,1001,747
306,18,24,305.0,20.0,258,6804,430,172
302,20,24,305.0,20.0,252,7522,433,181
309,16,24,305.0,20.0,263,6085,467,204
306,24,24,305.0,20.0,252,8970,1001,749
313,22,25,312.5,20.0,261,8255,426,165
310,23,25,312.5,20.0,257,8613,416,159
313,15,25,312.5,20.0,268,5728,508,240
312,20,25,312.5,20.0,262,7532,430,168
313,18,25,312.5,20.0,265,6811,499,234
311,18,25,312.5,20.0,263,6809,449,186
311,24,25,312.5,20.0,257,8975,435,178
312,17,25,312.5,20.0,265,6449,428,163
313,23,25,312.5,20.0,260,8616,421,161
310,20,25,312.5,20.0,260,7530,469,209
61,26,26,65.0,30.0,5,9447,21,16
62,31,26,65.0,30.0,3,11253,32,29
64,27,26,65.0,30.0,7,9811,24,17
66,34,26,65.0,30.0,10,12340,29,19
62,31,26,65.0,30.0,3,11253,28,25
61,32,26,65.0,30.0,3,11613,95,92
68,30,26,65.0,30.0,8,10898,36,28
62,30,26,65.0,30.0,2,10892,31,29
64,27,26,65.0,30.0,7,9811,55,48
65,33,26,65.0,30.0,8,11978,48,40
70,26,27,75.0,30.0,14,9456,44,30
76,28,27,75.0,30.0,18,10184,33,15
71,26,27,75.0,30.0,15,9457,31,16
79,31,27,75.0,30.0,20,11270,36,16
73,30,27,75.0,30.0,13,10903,47,34
75,29,27,75.0,30.0,16,10544,25,9
79,32,27,75.0,30.0,21,11631,34,13
70,33,27,75.0,30.0,13,11983,34,21
73,33,27,75.0,30.0,16,11986,24,8
71,25,27,75.0,30.0,16,9096,60,44
80,31,28,85.0,30.0,21,11271,25,4
88,31,28,85.0,30.0,29,11279,42,13
88,29,28,85.0,30.0,29,10557,63,34
84,26,28,85.0,30.0,28,9470,75,47
81,25,28,85.0,30.0,26,9106,57,31
81,30,28,85.0,30.0,21,10911,26,5
82,26,28,85.0,30.0,26,9468,59,33
88,31,28,85.0,30.0,29,11279,51,22
85,27,28,85.0,30.0,28,9832,41,13
89,26,28,85.0,30.0,33,9475,61,28
98,31,29,95.0,30.0,39,11289,55,16
93,33,29,95.0,30.0,36,12006,41,5
93,28,29,95.0,30.0,35,10201,66,31
99,28,29,95.0,30.0,41,10207,68,27
97,34,29,95.0,30.0,41,12371,54,13
94,29,29,95.0,30.0,35,10563,71,36
97,25,29,95.0,30.0,42,9122,78,36
99,32,29,95.0,30.0,41,11651,58,17
95,32,29,95.0,30.0,37,11647,57,20
90,29,29,95.0,30.0,31,10559,64,33
105,27,30,105.0,30.0,48,9852,91,43
107,27,30,105.0,30.0,50,9854,109,59
100,25,30,105.0,30.0,45,9125,112,67
107,29,30,105.0,30.0,48,10576,109,61
100,30,30,105.0,30.0,40,10930,62,22
102,27,30,105.0,30.0,45,9849,71,26
109,30,30,105.0,30.0,49,10939,122,73
103,26,30,105.0,30.0,47,9489,104,57
104,30,30,105.0,30.0,44,10934,114,70
102,26,30,105.0,30.0,46,9488,94,48
114,29,31,115.0,30.0,55,10583,102,47
115,25,31,115.0,30.0,60,9140,76,16
118,33,31,115.0,30.0,61,12031,130,69
113,33,31,115.0,30.0,56,12026,77,21
112,30,31,115.0,30.0,52,10942,86,34
114,31,31,115.0,30.0,55,11305,75,20
119,25,31,115.0,30.0,64,9144,106,42
118,34,31,115.0,30.0,62,12392,82,20
119,29,31,115.0,30.0,60,10588,94,34
112,30,31,115.0,30.0,52,10942,87,35
124,25,32,125.0,30.0,69,9149,174,105
127,28,32,125.0,30.0,69,10235,97,28
127,29,32,125.0,30.0,68,10596,87,19
122,25,32,125.0,30.0,67,9147,95,28
123,30,32,125.0,30.0,63,10953,109,46
127,27,32,125.0,30.0,70,9874,111,41
122,27,32,125.0,30.0,65,9869,102,37
125,29,32,125.0,30.0,66,10594,1001,935
120,32,32,125.0,30.0,62,11672,94,32
124,33,32,125.0,30.0,67,12037,84,17
138,34,33,135.0,30.0,82,12412,111,29
132,34,33,135.0,30.0,76,12406,90,14
131,28,33,135.0,30.0,73,10239,110,37
132,29,33,135.0,30.0,73,10601,109,36
132,27,33,135.0,30.0,75,9879,147,72
135,31,33,135.0,30.0,76,11326,97,21
130,27,33,135.0,30.0,73,9877,112,39
134,34,33,135.0,30.0,78,12408,95,17
131,25,33,135.0,30.0,76,9156,119,43
133,25,33,135.0,30.0,78,9158,141,63
147,33,34,145.0,30.0,90,12060,151,61
146,33,34,145.0,30.0,89,12059,111,22
148,34,34,145.0,30.0,92,12422,112,20
140,33,34,145.0,30.0,83,12053,116,33
145,31,34,145.0,30.0,86,11336,108,22
148,26,34,145.0,30.0,92,9534,127,35
145,32,34,145.0,30.0,87,11697,112,25
148,33,34,145.0,30.0,91,12061,114,23
149,34,34,145.0,30.0,93,12423,110,17
148,31,34,145.0,30.0,89,11339,150,61
157,34,35,155.0,30.0,101,12431,142,41
151,29,35,155.0,30.0,92,10620,125,33
154,30,35,155.0,30.0,94,10984,139,45
155,26,35,155.0,30.0,99,9541,168,69
152,25,35,155.0,30.0,97,9177,160,63
159,27,35,155.0,30.0,102,9906,164,62
156,26,35,155.0,30.0,100,9542,143,43
150,27,35,155.0,30.0,93,9897,155,62
151,28,35,155.0,30.0,93,10259,131,38
151,29,35,155.0,30.0,92,10620,126,34
169,33,36,165.0,30.0,112,12082,152,40
161,30,36,165.0,30.0,101,10991,219,118
163,27,36,165.0,30.0,106,9910,196,90
160,26,36,165.0,30.0,104,9546,131,27
161,27,36,165.0,30.0,104,9908,167,63
165,27,36,165.0,30.0,108,9912,188,80
168,27,36,165.0,30.0,111,9915,178,67
169,30,36,165.0,30.0,109,10999,175,66
166,26,36,165.0,30.0,110,9552,141,31
164,29,36,165.0,30.0,105,10633,143,38
178,25,37,175.0,30.0,123,9203,174,51
173,32,37,175.0,30.0,115,11725,150,35
170,27,37,175.0,30.0,113,9917,162,49
178,32,37,175.0,30.0,120,11730,216,96
179,33,37,175.0,30.0,122,12092,143,21
179,34,37,175.0,30.0,123,12453,152,29
176,28,37,175.0,30.0,118,10284,193,75
171,33,37,175.0,30.0,114,12084,136,22
176,27,37,175.0,30.0,119,9923,213,94
176,25,37,175.0,30.0,121,9201,204,83
182,27,38,185.0,30.0,125,9929,1001,876
186,34,38,185.0,30.0,130,12460,1001,871
186,32,38,185.0,30.0,128,11738,1001,873
184,25,38,185.0,30.0,129,9209,1001,872
185,34,38,185.0,30.0,129,12459,1001,872
186,27,38,185.0,30.0,129,9933,1001,872
187,28,38,185.0,30.0,129,10295,1001,872
184,31,38,185.0,30.0,125,11375,1001,876
188,32,38,185.0,30.0,130,11740,264,134
184,31,38,185.0,30.0,125,11375,1001,876
190,33,39,195.0,30.0,133,12103,1001,868
192,29,39,195.0,30.0,133,10661,1001,868
199,33,39,195.0,30.0,142,12112,305,163
197,27,39,195.0,30.0,140,9944,260,120
191,29,39,195.0,30.0,132,10660,1001,869
198,27,39,195.0,30.0,141,9945,317,176
198,32,39,195.0,30.0,140,11750,274,134
197,27,39,195.0,30.0,140,9944,274,134
194,25,39,195.0,30.0,139,9219,296,157
192,32,39,195.0,30.0,134,11744,1001,867
205,26,40,205.0,30.0,149,9591,269,120
200,30,40,205.0,30.0,140,11030,324,184
209,27,40,205.0,30.0,152,9956,265,113
203,25,40,205.0,30.0,148,9228,281,133
201,28,40,205.0,30.0,143,10309,268,125
209,34,40,205.0,30.0,153,12483,297,144
202,32,40,205.0,30.0,144,11754,287,143
206,25,40,205.0,30.0,151,9231,287,136
206,25,40,205.0,30.0,151,9231,272,121
200,27,40,205.0,30.0,143,9947,272,129
210,26,41,215.0,30.0,154,9596,289,135
210,29,41,215.0,30.0,151,10679,287,136
216,30,41,215.0,30.0,156,11046,1001,845
216,28,41,215.0,30.0,158,10324,281,123
217,28,41,215.0,30.0,159,10325,295,136
212,26,41,215.0,30.0,156,9598,304,148
210,27,41,215.0,30.0,153,9957,320,167
212,26,41,215.0,30.0,156,9598,289,133
211,25,41,215.0,30.0,156,9236,267,111
219,32,41,215.0,30.0,161,11771,372,211
228,32,42,225.0,30.0,170,11780,319,149
224,34,42,225.0,30.0,168,12498,329,161
222,27,42,225.0,30.0,165,9969,330,165
220,32,42,225.0,30.0,162,11772,362,200
226,25,42,225.0,30.0,171,9251,309,138
223,26,42,225.0,30.0,167,9609,286,119
220,30,42,225.0,30.0,160,11050,295,135
229,33,42,225.0,30.0,172,12142,318,146
224,29,42,225.0,30.0,165,10693,304,139
229,27,42,225.0,30.0,172,9976,293,121
234,33,43,235.0,30.0,177,12147,326,149
237,27,43,235.0,30.0,180,9984,324,144
231,30,43,235.0,30.0,171,11061,307,136
234,31,43,235.0,30.0,175,11425,1001,826
230,30,43,235.0,30.0,170,11060,343,173
233,33,43,235.0,30.0,176,12146,477,301
232,27,43,235.0,30.0,175,9979,1001,826
230,27,43,235.0,30.0,173,9977,305,132
237,33,43,235.0,30.0,180,12150,326,146
237,28,43,235.0,30.0,179,10345,312,133
248,31,44,245.0,30.0,189,11439,318,129
248,25,44,245.0,30.0,193,9273,315,122
244,27,44,245.0,30.0,187,9991,321,134
244,29,44,245.0,30.0,185,10713,342,157
244,32,44,245.0,30.0,186,11796,350,164
248,26,44,245.0,30.0,192,9634,335,143
243,26,44,245.0,30.0,187,9629,358,171
241,26,44,245.0,30.0,185,9627,311,126
244,26,44,245.0,30.0,188,9630,345,157
249,30,44,245.0,30.0,189,11079,326,137
258,27,45,255.0,30.0,201,10005,340,139
257,34,45,255.0,30.0,201,12531,343,142
252,30,45,255.0,30.0,192,11082,344,152
252,32,45,255.0,30.0,194,11804,362,168
253,25,45,255.0,30.0,198,9278,326,128
259,31,45,255.0,30.0,200,11450,355,155
259,28,45,255.0,30.0,201,10367,331,130
257,26,45,255.0,30.0,201,9643,331,130
257,26,45,255.0,30.0,201,9643,323,122
255,30,45,255.0,30.0,195,11085,336,141
262,30,46,265.0,30.0,202,11092,1001,799
264,30,46,265.0,30.0,204,11094,365,161
269,26,46,265.0,30.0,213,9655,359,146
265,34,46,265.0,30.0,209,12539,345,136
266,28,46,265.0,30.0,208,10374,358,150
261,31,46,265.0,30.0,202,11452,359,157
264,29,46,265.0,30.0,205,10733,332,127
269,25,46,265.0,30.0,214,9294,349,135
267,34,46,265.0,30.0,211,12541,351,140
262,28,46,265.0,30.0,204,10370,350,146
274,34,47,275.0,30.0,218,12548,384,166
271,25,47,275.0,30.0,216,9296,376,160
273,30,47,275.0,30.0,213,11103,353,140
272,32,47,275.0,30.0,214,11824,367,153
279,26,47,275.0,30.0,223,9665,346,123
277,34,47,275.0,30.0,221,12551,358,137
270,25,47,275.0,30.0,215,9295,339,124
274,31,47,275.0,30.0,215,11465,351,136
271,30,47,275.0,30.0,211,11101,1001,790
273,31,47,275.0,30.0,214,11464,394,180
280,30,48,285.0,30.0,220,11110,378,158
282,27,48,285.0,30.0,225,10029,391,166
289,28,48,285.0,30.0,231,10397,370,139
288,30,48,285.0,30.0,228,11118,374,146
287,33,48,285.0,30.0,230,12200,402,172
282,31,48,285.0,30.0,223,11473,356,133
284,34,48,285.0,30.0,228,12558,387,159
287,28,48,285.0,30.0,229,10395,356,127
280,31,48,285.0,30.0,221,11471,358,137
289,28,48,285.0,30.0,231,10397,411,180
290,27,49,295.0,30.0,233,10037,359,126
295,33,49,295.0,30.0,238,12208,399,161
295,25,49,295.0,30.0,240,9320,372,132
293,33,49,295.0,30.0,236,12206,403,167
292,27,49,295.0,30.0,235,10039,408,173
298,31,49,295.0,30.0,239,11489,380,141
299,27,49,295.0,30.0,242,10046,409,167
291,34,49,295.0,30.0,235,12565,389,154
297,25,49,295.0,30.0,242,9322,1001,759
296,25,49,295.0,30.0,241,9321,411,170
305,32,50,305.0,30.0,247,11857,414,167
305,31,50,305.0,30.0,246,11496,449,203
306,26,50,305.0,30.0,250,9692,1001,751
300,32,50,305.0,30.0,242,11852,391,149
306,34,50,305.0,30.0,250,12580,407,157
305,25,50,305.0,30.0,250,9330,416,166
303,26,50,305.0,30.0,247,9689,420,173
303,25,50,305.0,30.0,248,9328,1001,753
309,31,50,305.0,30.0,250,11500,1001,751
304,27,50,305.0,30.0,247,10051,411,164
311,34,51,312.5,30.0,255,12585,443,188
311,31,51,312.5,30.0,252,11502,423,171
314,33,51,312.5,30.0,257,12227,423,166
314,28,51,312.5,30.0,256,10422,430,174
313,28,51,312.5,30.0,255,10421,436,181
312,28,51,312.5,30.0,254,10420,427,173
310,33,51,312.5,30.0,253,12223,529,276
314,27,51,312.5,30.0,257,10061,426,169
311,28,51,312.5,30.0,253,10419,434,181
313,33,51,312.5,30.0,256,12226,423,167
64,37,52,65.0,40.0,11,13421,18,7
61,37,52,65.0,40.0,8,13418,9,1
68,39,52,65.0,40.0,17,14147,32,15
63,37,52,65.0,40.0,10,13420,11,1
66,44,52,65.0,40.0,20,15950,61,41
61,36,52,65.0,40.0,7,13057,192,185
63,40,52,65.0,40.0,13,14503,39,26
62,37,52,65.0,40.0,9,13419,17,8
63,42,52,65.0,40.0,15,15225,47,32
65,42,52,65.0,40.0,17,15227,72,55
71,36,53,75.0,40.0,17,13067,18,1
77,38,53,75.0,40.0,25,13795,36,11
78,36,53,75.0,40.0,24,13074,45,21
72,35,53,75.0,40.0,17,12707,30,13
75,38,53,75.0,40.0,23,13793,42,19
71,40,53,75.0,40.0,21,14511,48,27
74,43,53,75.0,40.0,27,15597,97,70
79,42,53,75.0,40.0,31,15241,72,41
70,38,53,75.0,40.0,18,13788,50,32
73,39,53,75.0,40.0,22,14152,31,9
81,39,54,85.0,40.0,30,14160,50,20
86,39,54,85.0,40.0,35,14165,60,25
88,35,54,85.0,40.0,33,12723,79,46
88,38,54,85.0,40.0,36,13806,60,24
83,44,54,85.0,40.0,37,15967,95,58
89,38,54,85.0,40.0,37,13807,83,46
81,43,54,85.0,40.0,34,15604,75,41
86,40,54,85.0,40.0,36,14526,93,57
80,40,54,85.0,40.0,30,14520,73,43
86,39,54,85.0,40.0,35,14165,62,27
90,38,55,95.0,40.0,38,13808,64,26
95,36,55,95.0,40.0,41,13091,52,11
92,36,55,95.0,40.0,38,13088,60,22
91,37,55,95.0,40.0,38,13448,64,26
92,40,55,95.0,40.0,42,14532,67,25
94,36,55,95.0,40.0,40,13090,53,13
99,43,55,95.0,40.0,52,15622,120,68
94,44,55,95.0,40.0,48,15978,83,35
90,36,55,95.0,40.0,36,13086,66,30
95,41,55,95.0,40.0,46,14896,111,65
107,35,56,105.0,40.0,52,12742,65,13
108,35,56,105.0,40.0,53,12743,99,46
102,38,56,105.0,40.0,50,13820,57,7
105,36,56,105.0,40.0,51,13101,69,18
106,40,56,105.0,40.0,56,14546,77,21
103,41,56,105.0,40.0,54,14904,70,16
101,40,56,105.0,40.0,51,14541,129,78
109,37,56,105.0,40.0,56,13466,70,14
107,44,56,105.0,40.0,61,15991,110,49
100,41,56,105.0,40.0,51,14901,113,62
111,38,57,115.0,40.0,59,13829,76,17
115,40,57,115.0,40.0,65,14555,92,27
119,43,57,115.0,40.0,72,15642,1001,929
117,43,57,115.0,40.0,70,15640,114,44
114,43,57,115.0,40.0,67,15637,121,54
118,41,57,115.0,40.0,69,14919,88,19
118,44,57,115.0,40.0,72,16002,130,58
118,42,57,115.0,40.0,70,15280,86,16
119,35,57,115.0,40.0,64,12754,71,7
114,42,57,115.0,40.0,66,15276,118,52
123,35,58,125.0,40.0,68,12758,79,11
126,44,58,125.0,40.0,80,16010,119,39
128,37,58,125.0,40.0,75,13485,141,66
126,40,58,125.0,40.0,76,14566,138,62
127,40,58,125.0,40.0,77,14567,155,78
120,36,58,125.0,40.0,66,13116,94,28
120,35,58,125.0,40.0,65,12755,109,44
123,36,58,125.0,40.0,69,13119,131,62
125,41,58,125.0,40.0,76,14926,107,31
128,43,58,125.0,40.0,81,15651,125,44
133,36,59,135.0,40.0,79,13129,85,6
135,35,59,135.0,40.0,80,12770,92,12
130,44,59,135.0,40.0,84,16014,119,35
130,43,59,135.0,40.0,83,15653,132,49
134,40,59,135.0,40.0,84,14574,101,17
131,39,59,135.0,40.0,80,14210,144,64
132,42,59,135.0,40.0,84,15294,143,59
133,41,59,135.0,40.0,84,14934,101,17
138,43,59,135.0,40.0,91,15661,141,50
132,36,59,135.0,40.0,78,13128,181,103
147,35,60,145.0,40.0,92,12782,112,20
145,42,60,145.0,40.0,97,15307,140,43
149,40,60,145.0,40.0,99,14589,155,56
140,41,60,145.0,40.0,91,14941,116,25
148,43,60,145.0,40.0,101,15671,178,77
144,36,60,145.0,40.0,90,13140,110,20
143,35,60,145.0,40.0,88,12778,123,35
143,42,60,145.0,40.0,95,15305,158,63
141,42,60,145.0,40.0,93,15303,153,60
145,44,60,145.0,40.0,99,16029,142,43
158,43,61,155.0,40.0,111,15681,183,72
159,43,61,155.0,40.0,112,15682,168,56
151,37,61,155.0,40.0,98,13508,131,33
156,36,61,155.0,40.0,102,13152,129,27
152,41,61,155.0,40.0,103,14953,185,82
153,37,61,155.0,40.0,100,13510,114,14
150,43,61,155.0,40.0,103,15673,154,51
157,36,61,155.0,40.0,103,13153,191,88
159,38,61,155.0,40.0,107,13877,122,15
159,43,61,155.0,40.0,112,15682,192,80
167,35,62,165.0,40.0,112,12802,129,17
168,38,62,165.0,40.0,116,13886,131,15
164,44,62,165.0,40.0,118,16048,172,54
165,38,62,165.0,40.0,113,13883,204,91
163,44,62,165.0,40.0,117,16047,819,702
164,40,62,165.0,40.0,114,14604,131,17
163,41,62,165.0,40.0,114,14964,194,80
167,44,62,165.0,40.0,121,16051,191,70
160,44,62,165.0,40.0,114,16044,184,70
160,42,62,165.0,40.0,112,15322,178,66
171,35,63,175.0,40.0,116,12806,183,67
170,44,63,175.0,40.0,124,16054,202,78
178,44,63,175.0,40.0,132,16062,198,66
176,40,63,175.0,40.0,126,14616,164,38
177,37,63,175.0,40.0,124,13534,189,65
179,38,63,175.0,40.0,127,13897,148,21
179,41,63,175.0,40.0,130,14980,186,56
174,41,63,175.0,40.0,125,14975,201,76
175,43,63,175.0,40.0,128,15698,179,51
170,41,63,175.0,40.0,121,14971,147,26
189,37,64,185.0,40.0,136,13546,1001,865
186,36,64,185.0,40.0,132,13182,1001,869
189,43,64,185.0,40.0,142,15712,1001,859
184,42,64,185.0,40.0,136,15346,1001,865
180,38,64,185.0,40.0,128,13898,257,129
187,39,64,185.0,40.0,136,14266,1001,865
184,38,64,185.0,40.0,132,13902,1001,869
186,42,64,185.0,40.0,138,15348,291,153
185,42,64,185.0,40.0,137,15347,1001,864
180,35,64,185.0,40.0,125,12815,152,27
198,42,65,195.0,40.0,150,15360,277,127
196,38,65,195.0,40.0,144,13914,287,143
192,36,65,195.0,40.0,138,13188,1001,863
197,44,65,195.0,40.0,151,16081,300,149
195,40,65,195.0,40.0,145,14635,282,137
191,42,65,195.0,40.0,143,15353,1001,858
193,43,65,195.0,40.0,146,15716,452,306
190,43,65,195.0,40.0,143,15713,1001,858
196,40,65,195.0,40.0,146,14636,286,140
194,43,65,195.0,40.0,147,15717,308,161
207,40,66,205.0,40.0,157,14647,313,156
209,36,66,205.0,40.0,155,13205,284,129
206,35,66,205.0,40.0,151,12841,288,137
205,41,66,205.0,40.0,156,15006,292,136
208,40,66,205.0,40.0,158,14648,343,185
204,38,66,205.0,40.0,152,13922,285,133
200,43,66,205.0,40.0,153,15723,282,129
206,39,66,205.0,40.0,155,14285,303,148
202,39,66,205.0,40.0,151,14281,294,143
209,42,66,205.0,40.0,161,15371,301,140
219,43,67,215.0,40.0,172,15742,317,145
219,39,67,215.0,40.0,168,14298,310,142
219,41,67,215.0,40.0,170,15020,312,142
218,39,67,215.0,40.0,167,14297,345,178
216,40,67,215.0,40.0,166,14656,360,194
210,37,67,215.0,40.0,157,13567,307,150
212,38,67,215.0,40.0,160,13930,296,136
215,36,67,215.0,40.0,161,13211,317,156
217,40,67,215.0,40.0,167,14657,419,252
219,36,67,215.0,40.0,165,13215,310,145
221,43,68,225.0,40.0,174,15744,314,140
226,43,68,225.0,40.0,179,15749,394,215
223,44,68,225.0,40.0,177,16107,336,159
229,43,68,225.0,40.0,182,15752,374,192
221,39,68,225.0,40.0,170,14300,299,129
228,42,68,225.0,40.0,180,15390,310,130
224,41,68,225.0,40.0,175,15025,326,151
227,39,68,225.0,40.0,176,14306,350,174
223,35,68,225.0,40.0,168,12858,329,161
225,38,68,225.0,40.0,173,13943,316,143
230,41,69,235.0,40.0,181,15031,327,146
230,39,69,235.0,40.0,179,14309,329,150
234,38,69,235.0,40.0,182,13952,314,132
234,42,69,235.0,40.0,186,15396,338,152
235,42,69,235.0,40.0,187,15397,329,142
236,43,69,235.0,40.0,189,15759,332,143
234,40,69,235.0,40.0,184,14674,355,171
236,41,69,235.0,40.0,187,15037,326,139
237,42,69,235.0,40.0,189,15399,332,143
235,38,69,235.0,40.0,183,13953,330,147
249,37,70,245.0,40.0,196,13606,340,144
247,40,70,245.0,40.0,197,14687,365,168
245,40,70,245.0,40.0,195,14685,346,151
245,41,70,245.0,40.0,196,15046,327,131
240,43,70,245.0,40.0,193,15763,336,143
240,35,70,245.0,40.0,185,12875,320,135
247,41,70,245.0,40.0,198,15048,353,155
241,37,70,245.0,40.0,188,13598,331,143
243,41,70,245.0,40.0,194,15044,342,148
247,42,70,245.0,40.0,199,15409,361,162
254,36,71,255.0,40.0,200,13250,372,172
251,37,71,255.0,40.0,198,13608,338,140
253,37,71,255.0,40.0,200,13610,387,187
252,36,71,255.0,40.0,198,13248,461,263
255,42,71,255.0,40.0,207,15417,342,135
258,42,71,255.0,40.0,210,15420,351,141
253,37,71,255.0,40.0,200,13610,432,232
250,42,71,255.0,40.0,202,15412,346,144
254,36,71,255.0,40.0,200,13250,336,136
250,44,71,255.0,40.0,204,16134,375,171
260,41,72,265.0,40.0,211,15061,358,147
269,36,72,265.0,40.0,215,13265,358,143
263,44,72,265.0,40.0,217,16147,357,140
262,39,72,265.0,40.0,211,14341,362,151
268,39,72,265.0,40.0,217,14347,361,144
266,39,72,265.0,40.0,215,14345,365,150
265,44,72,265.0,40.0,219,16149,362,143
262,38,72,265.0,40.0,210,13980,375,165
266,44,72,265.0,40.0,220,16150,369,149
265,36,72,265.0,40.0,211,13261,365,154
273,43,73,275.0,40.0,226,15796,400,174
272,37,73,275.0,40.0,219,13629,354,135
270,41,73,275.0,40.0,221,15071,360,139
271,43,73,275.0,40.0,224,15794,358,134
273,35,73,275.0,40.0,218,12908,404,186
278,38,73,275.0,40.0,226,13996,1001,775
274,42,73,275.0,40.0,226,15436,365,139
277,35,73,275.0,40.0,222,12912,371,149
275,42,73,275.0,40.0,227,15437,359,132
272,35,73,275.0,40.0,217,12907,346,129
282,38,74,285.0,40.0,230,14000,379,149
287,38,74,285.0,40.0,235,14005,374,139
289,39,74,285.0,40.0,238,14368,382,144
282,42,74,285.0,40.0,234,15444,383,149
285,43,74,285.0,40.0,238,15808,401,163
289,35,74,285.0,40.0,234,12924,389,155
281,41,74,285.0,40.0,232,15082,377,145
288,38,74,285.0,40.0,236,14006,366,130
289,39,74,285.0,40.0,238,14368,471,233
283,37,74,285.0,40.0,230,13640,403,173
293,37,75,295.0,40.0,240,13650,409,169
299,39,75,295.0,40.0,248,14378,1001,753
295,39,75,295.0,40.0,244,14374,386,142
298,39,75,295.0,40.0,247,14377,387,140
298,35,75,295.0,40.0,243,12933,388,145
298,43,75,295.0,40.0,251,15821,382,131
293,43,75,295.0,40.0,246,15816,383,137
293,43,75,295.0,40.0,246,15816,380,134
296,44,75,295.0,40.0,250,16180,389,139
291,42,75,295.0,40.0,243,15453,399,156
306,37,76,305.0,40.0,253,13663,448,195
308,43,76,305.0,40.0,261,15831,399,138
301,44,76,305.0,40.0,255,16185,428,173
305,42,76,305.0,40.0,257,15467,400,143
306,39,76,305.0,40.0,255,14385,402,147
300,39,76,305.0,40.0,249,14379,397,148
309,44,76,305.0,40.0,263,16193,444,181
306,39,76,305.0,40.0,255,14385,410,155
306,35,76,305.0,40.0,251,12941,1001,750
306,35,76,305.0,40.0,251,12941,1001,750
311,40,77,312.5,40.0,261,14751,402,141
311,40,77,312.5,40.0,261,14751,456,195
310,35,77,312.5,40.0,255,12945,474,219
310,41,77,312.5,40.0,261,15111,398,137
314,35,77,312.5,40.0,259,12949,404,145
310,36,77,312.5,40.0,256,13306,540,284
313,41,77,312.5,40.0,264,15114,421,157
313,39,77,312.5,40.0,262,14392,418,156
314,42,77,312.5,40.0,266,15476,406,140
313,37,77,312.5,40.0,260,13670,417,157
