x,y,cell,cell_x,cell_y,opt_traj,point_id,steps_taken,extra_steps
62,19,0,65.0,20.0,13,6921,87,74
65,18,0,65.0,20.0,17,6563,111,94
60,15,0,65.0,20.0,15,5475,1001,986
61,22,0,65.0,20.0,9,8003,1001,992
64,17,0,65.0,20.0,17,6201,37,20
67,21,0,65.0,20.0,16,7648,61,45
66,16,0,65.0,20.0,20,5842,468,448
60,18,0,65.0,20.0,12,6558,93,81
60,23,0,65.0,20.0,7,8363,22,15
66,19,0,65.0,20.0,17,6925,138,121
70,23,1,75.0,20.0,17,8373,1001,984
72,23,1,75.0,20.0,19,8375,43,24
71,24,1,75.0,20.0,17,8735,59,42
77,17,1,75.0,20.0,30,6214,52,22
79,20,1,75.0,20.0,29,7299,78,49
76,20,1,75.0,20.0,26,7296,80,54
71,15,1,75.0,20.0,26,5486,105,79
74,24,1,75.0,20.0,20,8738,65,45
70,15,1,75.0,20.0,25,5485,96,71
79,22,1,75.0,20.0,27,8021,53,26
82,18,2,85.0,20.0,34,6580,120,86
80,16,2,85.0,20.0,34,5856,71,37
81,17,2,85.0,20.0,34,6218,94,60
84,22,2,85.0,20.0,32,8026,1001,969
87,17,2,85.0,20.0,40,6224,73,33
83,20,2,85.0,20.0,33,7303,58,25
87,23,2,85.0,20.0,34,8390,76,42
88,18,2,85.0,20.0,40,6586,56,16
86,18,2,85.0,20.0,38,6584,103,65
85,23,2,85.0,20.0,32,8388,75,43
98,18,3,95.0,20.0,50,6596,75,25
96,21,3,95.0,20.0,45,7677,68,23
94,20,3,95.0,20.0,44,7314,101,57
90,17,3,95.0,20.0,43,6227,81,38
95,18,3,95.0,20.0,47,6593,82,35
93,22,3,95.0,20.0,41,8035,77,36
91,17,3,95.0,20.0,44,6228,74,30
98,18,3,95.0,20.0,50,6596,86,36
90,22,3,95.0,20.0,38,8032,107,69
92,17,3,95.0,20.0,45,6229,99,54
102,21,4,105.0,20.0,51,7683,129,78
109,21,4,105.0,20.0,58,7690,88,30
101,19,4,105.0,20.0,52,6960,70,18
107,16,4,105.0,20.0,61,5883,103,42
105,20,4,105.0,20.0,55,7325,169,114
109,21,4,105.0,20.0,58,7690,97,39
100,19,4,105.0,20.0,51,6959,67,16
101,15,4,105.0,20.0,56,5516,436,380
105,15,4,105.0,20.0,60,5520,111,51
104,20,4,105.0,20.0,54,7324,138,84
118,17,5,115.0,20.0,71,6255,92,21
114,17,5,115.0,20.0,67,6251,115,48
110,18,5,115.0,20.0,62,6608,104,42
113,21,5,115.0,20.0,62,7694,110,48
115,20,5,115.0,20.0,65,7335,81,16
114,18,5,115.0,20.0,66,6612,1001,935
112,21,5,115.0,20.0,61,7693,133,72
119,15,5,115.0,20.0,74,5534,156,82
114,23,5,115.0,20.0,61,8417,1001,940
112,16,5,115.0,20.0,66,5888,94,28
126,17,6,125.0,20.0,79,6263,97,18
125,16,6,125.0,20.0,79,5901,109,30
129,21,6,125.0,20.0,78,7710,225,147
121,20,6,125.0,20.0,71,7341,136,65
128,18,6,125.0,20.0,80,6626,203,123
127,24,6,125.0,20.0,73,8791,131,58
125,21,6,125.0,20.0,74,7706,116,42
123,17,6,125.0,20.0,76,6260,98,22
120,22,6,125.0,20.0,68,8062,110,42
121,24,6,125.0,20.0,67,8785,127,60
131,22,7,135.0,20.0,79,8073,113,34
132,17,7,135.0,20.0,85,6269,181,96
133,24,7,135.0,20.0,79,8797,226,147
133,24,7,135.0,20.0,79,8797,1001,922
139,24,7,135.0,20.0,85,8803,1001,916
137,23,7,135.0,20.0,84,8440,278,194
133,17,7,135.0,20.0,86,6270,204,118
130,24,7,135.0,20.0,76,8794,238,162
134,20,7,135.0,20.0,84,7354,230,146
139,21,7,135.0,20.0,88,7720,227,139
149,23,8,145.0,20.0,96,8452,261,165
142,21,8,145.0,20.0,91,7723,242,151
142,22,8,145.0,20.0,90,8084,249,159
145,20,8,145.0,20.0,95,7365,222,127
146,24,8,145.0,20.0,92,8810,224,132
144,19,8,145.0,20.0,95,7003,216,121
145,21,8,145.0,20.0,94,7726,243,149
142,20,8,145.0,20.0,92,7362,218,126
147,19,8,145.0,20.0,98,7006,204,106
147,17,8,145.0,20.0,100,6284,197,97
153,17,9,155.0,20.0,106,6290,207,101
155,19,9,155.0,20.0,106,7014,230,124
152,17,9,155.0,20.0,105,6289,259,154
152,17,9,155.0,20.0,105,6289,233,128
151,18,9,155.0,20.0,103,6649,209,106
150,16,9,155.0,20.0,104,5926,189,85
153,24,9,155.0,20.0,99,8817,271,172
157,21,9,155.0,20.0,106,7738,234,128
155,17,9,155.0,20.0,108,6292,267,159
155,20,9,155.0,20.0,105,7375,221,116
164,24,10,165.0,20.0,110,8828,234,124
169,18,10,165.0,20.0,121,6667,288,167
160,22,10,165.0,20.0,108,8102,219,111
166,20,10,165.0,20.0,116,7386,238,122
165,22,10,165.0,20.0,113,8107,238,125
162,18,10,165.0,20.0,114,6660,210,96
165,17,10,165.0,20.0,118,6302,209,91
160,16,10,165.0,20.0,114,5936,200,86
160,18,10,165.0,20.0,112,6658,212,100
163,16,10,165.0,20.0,117,5939,202,85
170,15,11,175.0,20.0,125,5585,1001,876
171,21,11,175.0,20.0,120,7752,233,113
175,23,11,175.0,20.0,122,8478,260,138
176,21,11,175.0,20.0,125,7757,254,129
174,22,11,175.0,20.0,122,8116,254,132
175,17,11,175.0,20.0,128,6312,229,101
176,18,11,175.0,20.0,128,6674,288,160
172,22,11,175.0,20.0,120,8114,233,113
175,16,11,175.0,20.0,129,5951,1001,872
178,17,11,175.0,20.0,131,6315,287,156
184,15,12,185.0,20.0,139,5599,735,596
185,23,12,185.0,20.0,132,8488,298,166
189,24,12,185.0,20.0,135,8853,283,148
181,20,12,185.0,20.0,131,7401,270,139
180,24,12,185.0,20.0,126,8844,283,157
186,21,12,185.0,20.0,135,7767,298,163
183,22,12,185.0,20.0,131,8125,330,199
186,17,12,185.0,20.0,139,6323,340,201
181,16,12,185.0,20.0,135,5957,352,217
188,20,12,185.0,20.0,138,7408,358,220
195,21,13,195.0,20.0,144,7776,285,141
198,17,13,195.0,20.0,151,6335,567,416
199,20,13,195.0,20.0,149,7419,277,128
199,23,13,195.0,20.0,146,8502,260,114
199,16,13,195.0,20.0,153,5975,1001,848
193,24,13,195.0,20.0,139,8857,310,171
193,18,13,195.0,20.0,145,6691,1001,856
193,15,13,195.0,20.0,148,5608,1001,853
190,21,13,195.0,20.0,139,7771,360,221
192,21,13,195.0,20.0,141,7773,307,166
205,15,14,205.0,20.0,160,5620,388,228
203,17,14,205.0,20.0,156,6340,331,175
207,21,14,205.0,20.0,156,7788,296,140
207,20,14,205.0,20.0,157,7427,294,137
204,21,14,205.0,20.0,153,7785,364,211
202,20,14,205.0,20.0,152,7422,320,168
202,16,14,205.0,20.0,156,5978,1001,845
204,20,14,205.0,20.0,154,7424,323,169
209,16,14,205.0,20.0,163,5985,1001,838
209,24,14,205.0,20.0,155,8873,267,112
214,16,15,215.0,20.0,168,5990,346,178
211,21,15,215.0,20.0,160,7792,293,133
215,21,15,215.0,20.0,164,7796,291,127
218,16,15,215.0,20.0,172,5994,584,412
215,21,15,215.0,20.0,164,7796,774,610
219,23,15,215.0,20.0,166,8522,273,107
212,17,15,215.0,20.0,165,6349,334,169
210,17,15,215.0,20.0,163,6347,1001,838
219,15,15,215.0,20.0,174,5634,692,518
217,21,15,215.0,20.0,166,7798,299,133
225,20,16,225.0,20.0,175,7445,289,114
220,17,16,225.0,20.0,173,6357,701,528
223,19,16,225.0,20.0,174,7082,713,539
228,17,16,225.0,20.0,181,6365,369,188
221,15,16,225.0,20.0,176,5636,688,512
222,16,16,225.0,20.0,176,5998,379,203
223,16,16,225.0,20.0,177,5999,334,157
220,17,16,225.0,20.0,173,6357,365,192
225,16,16,225.0,20.0,179,6001,683,504
224,15,16,225.0,20.0,179,5639,1001,822
237,15,17,235.0,20.0,192,5652,411,219
238,17,17,235.0,20.0,191,6375,421,230
232,23,17,235.0,20.0,179,8535,345,166
234,19,17,235.0,20.0,185,7093,316,131
234,21,17,235.0,20.0,183,7815,314,131
239,21,17,235.0,20.0,188,7820,309,121
230,24,17,235.0,20.0,176,8894,299,123
238,17,17,235.0,20.0,191,6375,406,215
232,24,17,235.0,20.0,178,8896,304,126
239,18,17,235.0,20.0,191,6737,431,240
248,23,18,245.0,20.0,195,8551,1001,806
249,15,18,245.0,20.0,204,5664,393,189
242,19,18,245.0,20.0,193,7101,336,143
241,19,18,245.0,20.0,192,7100,647,455
244,22,18,245.0,20.0,192,8186,416,224
242,18,18,245.0,20.0,194,6740,347,153
240,18,18,245.0,20.0,192,6738,407,215
242,16,18,245.0,20.0,196,6018,408,212
244,15,18,245.0,20.0,199,5659,1001,802
241,16,18,245.0,20.0,195,6017,1001,806
257,16,19,255.0,20.0,211,6033,388,177
252,16,19,255.0,20.0,206,6028,388,182
253,17,19,255.0,20.0,206,6390,388,182
253,23,19,255.0,20.0,200,8556,457,257
252,20,19,255.0,20.0,202,7472,395,193
250,19,19,255.0,20.0,201,7109,381,180
257,18,19,255.0,20.0,209,6755,389,180
251,21,19,255.0,20.0,200,7832,419,219
255,23,19,255.0,20.0,202,8558,445,243
251,21,19,255.0,20.0,200,7832,403,203
266,21,20,265.0,20.0,215,7847,430,215
261,22,20,265.0,20.0,209,8203,390,181
265,15,20,265.0,20.0,220,5680,384,164
268,23,20,265.0,20.0,215,8571,383,168
262,21,20,265.0,20.0,211,7843,369,158
260,19,20,265.0,20.0,211,7119,371,160
268,21,20,265.0,20.0,217,7849,375,158
269,23,20,265.0,20.0,216,8572,373,157
269,15,20,265.0,20.0,224,5684,441,217
263,16,20,265.0,20.0,217,6039,379,162
272,23,21,275.0,20.0,219,8575,396,177
270,22,21,275.0,20.0,218,8212,413,195
271,17,21,275.0,20.0,224,6408,395,171
278,18,21,275.0,20.0,230,6776,402,172
279,16,21,275.0,20.0,233,6055,404,171
277,19,21,275.0,20.0,228,7136,447,219
274,15,21,275.0,20.0,229,5689,502,273
273,24,21,275.0,20.0,219,8937,414,195
278,19,21,275.0,20.0,229,7137,411,182
272,15,21,275.0,20.0,227,5687,390,163
282,24,22,285.0,20.0,228,8946,403,175
288,17,22,285.0,20.0,241,6425,404,163
283,23,22,285.0,20.0,230,8586,1001,771
282,17,22,285.0,20.0,235,6419,492,257
283,21,22,285.0,20.0,232,7864,400,168
283,24,22,285.0,20.0,229,8947,420,191
289,23,22,285.0,20.0,236,8592,416,180
280,19,22,285.0,20.0,231,7139,420,189
282,23,22,285.0,20.0,229,8585,401,172
285,18,22,285.0,20.0,237,6783,488,251
295,16,23,295.0,20.0,249,6071,568,319
292,21,23,295.0,20.0,241,7873,464,223
297,15,23,295.0,20.0,252,5712,554,302
290,23,23,295.0,20.0,237,8593,408,171
293,15,23,295.0,20.0,248,5708,425,177
294,16,23,295.0,20.0,248,6070,506,258
298,18,23,295.0,20.0,250,6796,429,179
297,15,23,295.0,20.0,252,5712,416,164
298,20,23,295.0,20.0,248,7518,417,169
291,23,23,295.0,20.0,238,8594,403,165
307,15,24,305.0,20.0,262,5722,572,310
305,18,24,305.0,20.0,257,6803,422,165
301,21,24,305.0,20.0,250,7882,434,184
306,16,24,305.0,20.0,260,6082,502,242
309,23,24,305.0,20.0,256,8612,465,209
309,24,24,305.0,20.0,255,8973,565,310
301,15,24,305.0,20.0,256,5716,433,177
302,18,24,305.0,20.0,254,6800,447,193
309,18,24,305.0,20.0,261,6807,419,158
306,20,24,305.0,20.0,256,7526,444,188
314,21,25,312.5,20.0,263,7895,444,181
313,23,25,312.5,20.0,260,8616,456,196
312,22,25,312.5,20.0,260,8254,455,195
314,22,25,312.5,20.0,262,8256,459,197
310,23,25,312.5,20.0,257,8613,569,312
311,16,25,312.5,20.0,265,6087,587,322
310,23,25,312.5,20.0,257,8613,615,358
310,22,25,312.5,20.0,258,8252,453,195
312,20,25,312.5,20.0,262,7532,430,168
311,19,25,312.5,20.0,262,7170,641,379
65,27,26,65.0,30.0,8,9812,146,138
65,31,26,65.0,30.0,6,11256,35,29
65,29,26,65.0,30.0,6,10534,16,10
62,31,26,65.0,30.0,3,11253,31,28
69,33,26,65.0,30.0,12,11982,47,35
61,31,26,65.0,30.0,2,11252,82,80
64,25,26,65.0,30.0,9,9089,32,23
62,26,26,65.0,30.0,6,9448,20,14
61,32,26,65.0,30.0,3,11613,13,10
62,31,26,65.0,30.0,3,11253,35,32
76,25,27,75.0,30.0,21,9101,1001,980
76,33,27,75.0,30.0,19,11989,37,18
70,31,27,75.0,30.0,11,11261,24,13
78,31,27,75.0,30.0,19,11269,169,150
70,34,27,75.0,30.0,14,12344,15,1
74,29,27,75.0,30.0,15,10543,38,23
79,28,27,75.0,30.0,21,10187,50,29
71,27,27,75.0,30.0,14,9818,94,80
76,31,27,75.0,30.0,17,11267,32,15
75,25,27,75.0,30.0,20,9100,195,175
89,34,28,85.0,30.0,33,12363,68,35
82,28,28,85.0,30.0,24,10190,75,51
81,25,28,85.0,30.0,26,9106,40,14
86,30,28,85.0,30.0,26,10916,85,59
87,33,28,85.0,30.0,30,12000,66,36
82,27,28,85.0,30.0,25,9829,320,295
87,30,28,85.0,30.0,27,10917,58,31
84,32,28,85.0,30.0,26,11636,62,36
86,28,28,85.0,30.0,28,10194,59,31
86,26,28,85.0,30.0,30,9472,1001,971
94,26,29,95.0,30.0,38,9480,134,96
92,32,29,95.0,30.0,34,11644,53,19
93,32,29,95.0,30.0,35,11645,156,121
91,26,29,95.0,30.0,35,9477,1001,966
96,33,29,95.0,30.0,39,12009,97,58
96,30,29,95.0,30.0,36,10926,100,64
98,32,29,95.0,30.0,40,11650,65,25
99,28,29,95.0,30.0,41,10207,77,36
90,31,29,95.0,30.0,31,11281,65,34
94,34,29,95.0,30.0,38,12368,88,50
107,25,30,105.0,30.0,52,9132,109,57
109,27,30,105.0,30.0,52,9856,1001,949
106,31,30,105.0,30.0,47,11297,226,179
102,28,30,105.0,30.0,44,10210,122,78
101,31,30,105.0,30.0,42,11292,74,32
107,33,30,105.0,30.0,50,12020,85,35
105,27,30,105.0,30.0,48,9852,1001,953
109,34,30,105.0,30.0,53,12383,104,51
103,26,30,105.0,30.0,47,9489,77,30
108,27,30,105.0,30.0,51,9855,273,222
115,31,31,115.0,30.0,56,11306,131,75
119,29,31,115.0,30.0,60,10588,109,49
112,34,31,115.0,30.0,56,12386,104,48
116,34,31,115.0,30.0,60,12390,102,42
112,30,31,115.0,30.0,52,10942,1001,949
115,28,31,115.0,30.0,57,10223,91,34
118,27,31,115.0,30.0,61,9865,124,63
110,34,31,115.0,30.0,54,12384,1001,947
117,30,31,115.0,30.0,57,10947,136,79
114,26,31,115.0,30.0,58,9500,132,74
120,29,32,125.0,30.0,61,10589,125,64
125,32,32,125.0,30.0,67,11677,428,361
125,25,32,125.0,30.0,70,9150,157,87
127,29,32,125.0,30.0,68,10596,107,39
120,29,32,125.0,30.0,61,10589,100,39
125,28,32,125.0,30.0,67,10233,1001,934
122,28,32,125.0,30.0,64,10230,143,79
128,25,32,125.0,30.0,73,9153,295,222
127,27,32,125.0,30.0,70,9874,120,50
120,28,32,125.0,30.0,62,10228,94,32
139,28,33,135.0,30.0,81,10247,1001,920
131,30,33,135.0,30.0,71,10961,160,89
137,32,33,135.0,30.0,79,11689,861,782
134,28,33,135.0,30.0,76,10242,201,125
134,27,33,135.0,30.0,77,9881,278,201
137,29,33,135.0,30.0,78,10606,381,303
133,25,33,135.0,30.0,78,9158,238,160
131,29,33,135.0,30.0,72,10600,217,145
137,25,33,135.0,30.0,82,9162,242,160
133,26,33,135.0,30.0,77,9519,271,194
143,26,34,145.0,30.0,87,9529,255,168
140,31,34,145.0,30.0,81,11331,1001,920
145,28,34,145.0,30.0,87,10253,262,175
140,31,34,145.0,30.0,81,11331,1001,920
144,25,34,145.0,30.0,89,9169,240,151
140,29,34,145.0,30.0,81,10609,1001,920
142,33,34,145.0,30.0,85,12055,827,742
147,30,34,145.0,30.0,87,10977,225,138
142,34,34,145.0,30.0,86,12416,1001,915
149,31,34,145.0,30.0,90,11340,237,147
150,25,35,155.0,30.0,95,9175,204,109
152,28,35,155.0,30.0,94,10260,222,128
156,27,35,155.0,30.0,99,9903,271,172
152,34,35,155.0,30.0,96,12426,832,736
154,29,35,155.0,30.0,95,10623,233,138
156,28,35,155.0,30.0,98,10264,239,141
153,27,35,155.0,30.0,96,9900,294,198
154,28,35,155.0,30.0,96,10262,328,232
153,26,35,155.0,30.0,97,9539,265,168
150,30,35,155.0,30.0,90,10980,1001,911
165,32,36,165.0,30.0,107,11717,348,241
160,30,36,165.0,30.0,100,10990,242,142
165,27,36,165.0,30.0,108,9912,1001,893
169,30,36,165.0,30.0,109,10999,319,210
162,30,36,165.0,30.0,102,10992,272,170
169,32,36,165.0,30.0,111,11721,1001,890
160,31,36,165.0,30.0,101,11351,350,249
163,25,36,165.0,30.0,108,9188,230,122
166,27,36,165.0,30.0,109,9913,279,170
166,28,36,165.0,30.0,108,10274,247,139
179,29,37,175.0,30.0,120,10648,322,202
174,31,37,175.0,30.0,115,11365,1001,886
175,29,37,175.0,30.0,116,10644,268,152
175,30,37,175.0,30.0,115,11005,265,150
175,34,37,175.0,30.0,119,12449,753,634
174,34,37,175.0,30.0,118,12448,758,640
179,27,37,175.0,30.0,122,9926,281,159
178,32,37,175.0,30.0,120,11730,250,130
178,29,37,175.0,30.0,119,10647,252,133
174,33,37,175.0,30.0,117,12087,402,285
181,25,38,185.0,30.0,126,9206,246,120
189,27,38,185.0,30.0,132,9936,248,116
189,30,38,185.0,30.0,129,11019,264,135
189,28,38,185.0,30.0,131,10297,255,124
181,33,38,185.0,30.0,124,12094,275,151
184,28,38,185.0,30.0,126,10292,263,137
183,27,38,185.0,30.0,126,9930,248,122
183,27,38,185.0,30.0,126,9930,251,125
180,32,38,185.0,30.0,122,11732,269,147
184,33,38,185.0,30.0,127,12097,1001,874
192,26,39,195.0,30.0,136,9578,287,151
197,32,39,195.0,30.0,139,11749,264,125
190,31,39,195.0,30.0,131,11381,296,165
198,27,39,195.0,30.0,141,9945,264,123
191,27,39,195.0,30.0,134,9938,265,131
198,27,39,195.0,30.0,141,9945,287,146
195,26,39,195.0,30.0,139,9581,255,116
191,32,39,195.0,30.0,133,11743,297,164
196,26,39,195.0,30.0,140,9582,258,118
193,28,39,195.0,30.0,135,10301,255,120
209,27,40,205.0,30.0,152,9956,275,123
200,34,40,205.0,30.0,144,12474,375,231
206,29,40,205.0,30.0,147,10675,315,168
200,32,40,205.0,30.0,142,11752,422,280
207,33,40,205.0,30.0,150,12120,390,240
202,30,40,205.0,30.0,142,11032,306,164
204,25,40,205.0,30.0,149,9229,267,118
209,33,40,205.0,30.0,152,12122,297,145
205,34,40,205.0,30.0,149,12479,330,181
200,34,40,205.0,30.0,144,12474,363,219
212,33,41,215.0,30.0,155,12125,306,151
214,27,41,215.0,30.0,157,9961,295,138
210,29,41,215.0,30.0,151,10679,318,167
217,26,41,215.0,30.0,161,9603,301,140
216,34,41,215.0,30.0,160,12490,296,136
214,25,41,215.0,30.0,159,9239,280,121
211,25,41,215.0,30.0,156,9236,273,117
219,29,41,215.0,30.0,160,10688,320,160
218,29,41,215.0,30.0,159,10687,297,138
219,26,41,215.0,30.0,163,9605,284,121
227,30,42,225.0,30.0,167,11057,312,145
223,27,42,225.0,30.0,166,9970,305,139
221,32,42,225.0,30.0,163,11773,319,156
228,31,42,225.0,30.0,169,11419,294,125
229,29,42,225.0,30.0,170,10698,318,148
220,26,42,225.0,30.0,164,9606,289,125
227,25,42,225.0,30.0,172,9252,299,127
229,34,42,225.0,30.0,173,12503,355,182
224,30,42,225.0,30.0,164,11054,306,142
222,27,42,225.0,30.0,165,9969,315,150
234,28,43,235.0,30.0,176,10342,299,123
237,26,43,235.0,30.0,181,9623,308,127
234,30,43,235.0,30.0,174,11064,321,147
238,30,43,235.0,30.0,178,11068,341,163
234,28,43,235.0,30.0,176,10342,299,123
239,26,43,235.0,30.0,183,9625,349,166
236,32,43,235.0,30.0,178,11788,480,302
236,28,43,235.0,30.0,178,10344,414,236
238,27,43,235.0,30.0,181,9985,1001,820
237,27,43,235.0,30.0,180,9984,306,126
248,29,44,245.0,30.0,189,10717,464,275
247,31,44,245.0,30.0,188,11438,442,254
241,26,44,245.0,30.0,185,9627,411,226
241,26,44,245.0,30.0,185,9627,384,199
241,26,44,245.0,30.0,185,9627,305,120
243,30,44,245.0,30.0,183,11073,1001,818
242,34,44,245.0,30.0,186,12516,343,157
240,25,44,245.0,30.0,185,9265,425,240
249,32,44,245.0,30.0,191,11801,500,309
240,26,44,245.0,30.0,184,9626,462,278
256,32,45,255.0,30.0,198,11808,349,151
257,27,45,255.0,30.0,200,10004,490,290
256,33,45,255.0,30.0,199,12169,348,149
254,30,45,255.0,30.0,194,11084,487,293
250,33,45,255.0,30.0,193,12163,375,182
255,25,45,255.0,30.0,200,9280,477,277
257,30,45,255.0,30.0,197,11087,352,155
259,33,45,255.0,30.0,202,12172,407,205
250,30,45,255.0,30.0,190,11080,1001,811
256,25,45,255.0,30.0,201,9281,1001,800
268,29,46,265.0,30.0,209,10737,372,163
269,33,46,265.0,30.0,212,12182,1001,789
262,27,46,265.0,30.0,205,10009,415,210
266,25,46,265.0,30.0,211,9291,409,198
264,31,46,265.0,30.0,205,11455,360,155
262,25,46,265.0,30.0,207,9287,1001,794
260,31,46,265.0,30.0,201,11451,407,206
269,31,46,265.0,30.0,210,11460,416,206
263,29,46,265.0,30.0,204,10732,393,189
261,26,46,265.0,30.0,205,9647,378,173
274,27,47,275.0,30.0,217,10021,397,180
273,34,47,275.0,30.0,217,12547,377,160
272,27,47,275.0,30.0,215,10019,410,195
277,31,47,275.0,30.0,218,11468,437,219
272,32,47,275.0,30.0,214,11824,399,185
275,33,47,275.0,30.0,218,12188,1001,783
274,30,47,275.0,30.0,214,11104,466,252
272,32,47,275.0,30.0,214,11824,365,151
272,34,47,275.0,30.0,216,12546,401,185
270,34,47,275.0,30.0,214,12544,1001,787
289,28,48,285.0,30.0,231,10397,434,203
283,28,48,285.0,30.0,225,10391,415,190
286,26,48,285.0,30.0,230,9672,397,167
286,28,48,285.0,30.0,228,10394,384,156
281,30,48,285.0,30.0,221,11111,405,184
288,30,48,285.0,30.0,228,11118,384,156
286,34,48,285.0,30.0,230,12560,389,159
284,31,48,285.0,30.0,225,11475,553,328
281,34,48,285.0,30.0,225,12555,383,158
288,29,48,285.0,30.0,229,10757,427,198
290,34,49,295.0,30.0,234,12564,410,176
296,30,49,295.0,30.0,236,11126,410,174
291,34,49,295.0,30.0,235,12565,393,158
298,34,49,295.0,30.0,242,12572,409,167
298,30,49,295.0,30.0,238,11128,395,157
295,25,49,295.0,30.0,240,9320,415,175
299,31,49,295.0,30.0,240,11490,394,154
293,26,49,295.0,30.0,237,9679,428,191
294,28,49,295.0,30.0,236,10402,426,190
292,30,49,295.0,30.0,232,11122,414,182
301,34,50,305.0,30.0,245,12575,631,386
308,26,50,305.0,30.0,252,9694,437,185
307,30,50,305.0,30.0,247,11137,1001,754
301,34,50,305.0,30.0,245,12575,455,210
302,30,50,305.0,30.0,242,11132,431,189
306,26,50,305.0,30.0,250,9692,440,190
300,27,50,305.0,30.0,243,10047,505,262
306,31,50,305.0,30.0,247,11497,443,196
300,27,50,305.0,30.0,243,10047,433,190
302,29,50,305.0,30.0,243,10771,439,196
311,34,51,312.5,30.0,255,12585,442,187
312,25,51,312.5,30.0,257,9337,566,309
313,31,51,312.5,30.0,254,11504,499,245
312,32,51,312.5,30.0,254,11864,453,199
312,27,51,312.5,30.0,255,10059,490,235
312,34,51,312.5,30.0,256,12586,449,193
310,30,51,312.5,30.0,250,11140,467,217
310,28,51,312.5,30.0,252,10418,602,350
312,30,51,312.5,30.0,252,11142,432,180
310,30,51,312.5,30.0,250,11140,557,307
60,42,52,65.0,40.0,12,15222,53,41
62,40,52,65.0,40.0,12,14502,56,44
63,42,52,65.0,40.0,15,15225,82,67
64,35,52,65.0,40.0,9,12699,32,23
62,42,52,65.0,40.0,14,15224,56,42
69,42,52,65.0,40.0,21,15231,48,27
68,42,52,65.0,40.0,20,15230,73,53
68,38,52,65.0,40.0,16,13786,31,15
60,41,52,65.0,40.0,11,14861,120,109
68,43,52,65.0,40.0,21,15591,80,59
70,38,53,75.0,40.0,18,13788,31,13
73,44,53,75.0,40.0,27,15957,236,209
77,40,53,75.0,40.0,27,14517,64,37
75,36,53,75.0,40.0,21,13071,29,8
79,36,53,75.0,40.0,25,13075,106,81
75,44,53,75.0,40.0,29,15959,97,68
73,44,53,75.0,40.0,27,15957,70,43
74,38,53,75.0,40.0,22,13792,35,13
72,36,53,75.0,40.0,18,13068,31,13
74,35,53,75.0,40.0,19,12709,119,100
83,36,54,85.0,40.0,29,13079,44,15
80,39,54,85.0,40.0,29,14159,32,3
82,37,54,85.0,40.0,29,13439,49,20
87,44,54,85.0,40.0,41,15971,118,77
82,44,54,85.0,40.0,36,15966,112,76
81,40,54,85.0,40.0,31,14521,69,38
89,44,54,85.0,40.0,43,15973,84,41
86,36,54,85.0,40.0,32,13082,34,2
87,37,54,85.0,40.0,34,13444,170,136
84,41,54,85.0,40.0,35,14885,59,24
97,44,55,95.0,40.0,51,15981,138,87
91,42,55,95.0,40.0,43,15253,96,53
97,40,55,95.0,40.0,47,14537,59,12
95,39,55,95.0,40.0,44,14174,63,19
90,43,55,95.0,40.0,43,15613,106,63
99,35,55,95.0,40.0,44,12734,76,32
93,37,55,95.0,40.0,40,13450,61,21
94,37,55,95.0,40.0,41,13451,64,23
95,42,55,95.0,40.0,47,15257,100,53
90,38,55,95.0,40.0,38,13808,123,85
109,35,56,105.0,40.0,54,12744,62,8
101,41,56,105.0,40.0,52,14902,118,66
108,36,56,105.0,40.0,54,13104,78,24
101,39,56,105.0,40.0,50,14180,60,10
101,39,56,105.0,40.0,50,14180,54,4
104,37,56,105.0,40.0,51,13461,56,5
108,42,56,105.0,40.0,60,15270,124,64
103,42,56,105.0,40.0,55,15265,1001,946
105,39,56,105.0,40.0,54,14184,67,13
100,39,56,105.0,40.0,49,14179,54,5
119,36,57,115.0,40.0,65,13115,180,115
112,36,57,115.0,40.0,58,13108,91,33
117,41,57,115.0,40.0,68,14918,125,57
118,39,57,115.0,40.0,67,14197,139,72
116,42,57,115.0,40.0,68,15278,116,48
114,37,57,115.0,40.0,61,13471,100,39
115,43,57,115.0,40.0,68,15638,114,46
118,38,57,115.0,40.0,66,13836,149,83
114,41,57,115.0,40.0,65,14915,75,10
119,43,57,115.0,40.0,72,15642,149,77
121,39,58,125.0,40.0,70,14200,86,16
122,40,58,125.0,40.0,72,14562,97,25
125,38,58,125.0,40.0,73,13843,97,24
128,44,58,125.0,40.0,82,16012,164,82
120,40,58,125.0,40.0,70,14560,148,78
129,40,58,125.0,40.0,79,14569,153,74
129,44,58,125.0,40.0,83,16013,157,74
123,43,58,125.0,40.0,76,15646,153,77
123,40,58,125.0,40.0,73,14563,109,36
120,36,58,125.0,40.0,66,13116,144,78
139,35,59,135.0,40.0,84,12774,836,752
132,36,59,135.0,40.0,78,13128,858,780
135,44,59,135.0,40.0,89,16019,868,779
136,42,59,135.0,40.0,88,15298,858,770
138,43,59,135.0,40.0,91,15661,823,732
137,41,59,135.0,40.0,88,14938,839,751
130,36,59,135.0,40.0,76,13126,185,109
131,40,59,135.0,40.0,81,14571,152,71
136,41,59,135.0,40.0,87,14937,848,761
132,40,59,135.0,40.0,82,14572,857,775
141,38,60,145.0,40.0,89,13859,858,769
143,44,60,145.0,40.0,97,16027,894,797
145,35,60,145.0,40.0,90,12780,843,753
143,41,60,145.0,40.0,94,14944,1001,907
140,44,60,145.0,40.0,94,16024,826,732
144,43,60,145.0,40.0,97,15667,863,766
144,41,60,145.0,40.0,95,14945,870,775
141,40,60,145.0,40.0,91,14581,876,785
141,38,60,145.0,40.0,89,13859,864,775
140,42,60,145.0,40.0,92,15302,824,732
159,35,61,155.0,40.0,104,12794,847,743
152,43,61,155.0,40.0,105,15675,1001,896
159,38,61,155.0,40.0,107,13877,781,674
150,42,61,155.0,40.0,102,15312,876,774
150,37,61,155.0,40.0,97,13507,880,783
150,40,61,155.0,40.0,100,14590,841,741
153,42,61,155.0,40.0,105,15315,867,762
156,37,61,155.0,40.0,103,13513,813,710
157,38,61,155.0,40.0,105,13875,783,678
159,43,61,155.0,40.0,112,15682,862,750
166,36,62,165.0,40.0,112,13162,1001,889
169,38,62,165.0,40.0,117,13887,790,673
163,43,62,165.0,40.0,116,15686,834,718
166,44,62,165.0,40.0,120,16050,778,658
168,42,62,165.0,40.0,120,15330,766,646
169,36,62,165.0,40.0,115,13165,1001,886
168,39,62,165.0,40.0,117,14247,783,666
166,39,62,165.0,40.0,115,14245,810,695
162,35,62,165.0,40.0,107,12797,808,701
168,36,62,165.0,40.0,114,13164,820,706
175,37,63,175.0,40.0,122,13532,777,655
170,35,63,175.0,40.0,115,12805,757,642
177,42,63,175.0,40.0,129,15339,845,716
179,41,63,175.0,40.0,130,14980,1001,871
171,36,63,175.0,40.0,117,13167,777,660
174,37,63,175.0,40.0,121,13531,766,645
179,40,63,175.0,40.0,129,14619,290,161
178,39,63,175.0,40.0,127,14257,277,150
179,36,63,175.0,40.0,125,13175,463,338
179,42,63,175.0,40.0,131,15341,797,666
180,39,64,185.0,40.0,129,14259,265,136
183,37,64,185.0,40.0,130,13540,265,135
181,40,64,185.0,40.0,131,14621,783,652
183,43,64,185.0,40.0,136,15706,263,127
184,40,64,185.0,40.0,134,14624,282,148
180,38,64,185.0,40.0,128,13898,1001,873
185,41,64,185.0,40.0,136,14986,325,189
183,39,64,185.0,40.0,132,14262,270,138
181,35,64,185.0,40.0,126,12816,397,271
188,36,64,185.0,40.0,134,13184,349,215
199,36,65,195.0,40.0,145,13195,1001,856
190,38,65,195.0,40.0,138,13908,1001,863
190,36,65,195.0,40.0,136,13186,1001,865
199,39,65,195.0,40.0,148,14278,288,140
192,42,65,195.0,40.0,144,15354,319,175
191,38,65,195.0,40.0,139,13909,288,149
194,41,65,195.0,40.0,145,14995,311,166
195,38,65,195.0,40.0,143,13913,300,157
196,38,65,195.0,40.0,144,13914,288,144
191,43,65,195.0,40.0,144,15714,301,157
205,35,66,205.0,40.0,150,12840,323,173
200,37,66,205.0,40.0,147,13557,292,145
205,41,66,205.0,40.0,156,15006,393,237
207,38,66,205.0,40.0,155,13925,1001,846
204,43,66,205.0,40.0,157,15727,441,284
200,39,66,205.0,40.0,149,14279,275,126
204,43,66,205.0,40.0,157,15727,315,158
200,41,66,205.0,40.0,151,15001,299,148
203,35,66,205.0,40.0,148,12838,1001,853
204,38,66,205.0,40.0,152,13922,299,147
212,39,67,215.0,40.0,161,14291,300,139
216,35,67,215.0,40.0,161,12851,287,126
215,38,67,215.0,40.0,163,13933,1001,838
218,38,67,215.0,40.0,166,13936,322,156
216,42,67,215.0,40.0,168,15378,313,145
210,43,67,215.0,40.0,163,15733,319,156
214,44,67,215.0,40.0,168,16098,295,127
214,37,67,215.0,40.0,161,13571,348,187
212,43,67,215.0,40.0,165,15735,335,170
210,43,67,215.0,40.0,163,15733,323,160
224,41,68,225.0,40.0,175,15025,321,146
226,37,68,225.0,40.0,173,13583,310,137
229,39,68,225.0,40.0,178,14308,339,161
224,44,68,225.0,40.0,178,16108,306,128
224,35,68,225.0,40.0,169,12859,346,177
221,41,68,225.0,40.0,172,15022,395,223
226,44,68,225.0,40.0,180,16110,332,152
227,40,68,225.0,40.0,177,14667,316,139
225,38,68,225.0,40.0,173,13943,302,129
227,41,68,225.0,40.0,178,15028,338,160
238,36,69,235.0,40.0,184,13234,466,282
235,37,69,235.0,40.0,182,13592,356,174
233,42,69,235.0,40.0,185,15395,337,152
234,43,69,235.0,40.0,187,15757,314,127
235,42,69,235.0,40.0,187,15397,348,161
238,40,69,235.0,40.0,188,14678,335,147
237,43,69,235.0,40.0,190,15760,318,128
235,39,69,235.0,40.0,184,14314,395,211
232,38,69,235.0,40.0,180,13950,321,141
235,41,69,235.0,40.0,186,15036,333,147
240,35,70,245.0,40.0,185,12875,353,168
243,37,70,245.0,40.0,190,13600,368,178
248,37,70,245.0,40.0,195,13605,386,191
240,41,70,245.0,40.0,191,15041,360,169
243,37,70,245.0,40.0,190,13600,437,247
247,40,70,245.0,40.0,197,14687,333,136
245,39,70,245.0,40.0,194,14324,363,169
243,37,70,245.0,40.0,190,13600,362,172
243,42,70,245.0,40.0,195,15405,359,164
248,38,70,245.0,40.0,196,13966,379,183
256,44,71,255.0,40.0,210,16140,386,176
253,42,71,255.0,40.0,205,15415,381,176
251,38,71,255.0,40.0,199,13969,377,178
250,40,71,255.0,40.0,200,14690,350,150
250,37,71,255.0,40.0,197,13607,454,257
251,37,71,255.0,40.0,198,13608,419,221
257,38,71,255.0,40.0,205,13975,411,206
257,37,71,255.0,40.0,204,13614,418,214
257,36,71,255.0,40.0,203,13253,359,156
258,42,71,255.0,40.0,210,15420,341,131
269,37,72,265.0,40.0,216,13626,411,195
263,39,72,265.0,40.0,212,14342,369,157
266,44,72,265.0,40.0,220,16150,370,150
267,42,72,265.0,40.0,219,15429,380,161
265,41,72,265.0,40.0,216,15066,353,137
264,35,72,265.0,40.0,209,12899,362,153
268,40,72,265.0,40.0,218,14708,354,136
264,43,72,265.0,40.0,217,15787,345,128
264,39,72,265.0,40.0,213,14343,361,148
267,44,72,265.0,40.0,221,16151,361,140
275,41,73,275.0,40.0,226,15076,401,175
272,40,73,275.0,40.0,222,14712,372,150
271,38,73,275.0,40.0,219,13989,363,144
279,43,73,275.0,40.0,232,15802,383,151
279,43,73,275.0,40.0,232,15802,398,166
274,35,73,275.0,40.0,219,12909,376,157
278,44,73,275.0,40.0,232,16162,371,139
277,39,73,275.0,40.0,226,14356,364,138
273,43,73,275.0,40.0,226,15796,354,128
271,42,73,275.0,40.0,223,15433,440,217
287,42,74,285.0,40.0,239,15449,444,205
285,42,74,285.0,40.0,237,15447,543,306
289,35,74,285.0,40.0,234,12924,401,167
282,44,74,285.0,40.0,236,16166,411,175
280,40,74,285.0,40.0,230,14720,367,137
283,43,74,285.0,40.0,236,15806,464,228
281,38,74,285.0,40.0,229,13999,417,188
287,38,74,285.0,40.0,235,14005,411,176
282,43,74,285.0,40.0,235,15805,414,179
281,44,74,285.0,40.0,235,16165,1001,766
294,43,75,295.0,40.0,247,15817,547,300
291,40,75,295.0,40.0,241,14731,412,171
297,35,75,295.0,40.0,242,12932,419,177
292,42,75,295.0,40.0,244,15454,429,185
290,41,75,295.0,40.0,241,15091,470,229
291,40,75,295.0,40.0,241,14731,421,180
296,36,75,295.0,40.0,242,13292,392,150
291,36,75,295.0,40.0,237,13287,380,143
290,39,75,295.0,40.0,239,14369,427,188
294,40,75,295.0,40.0,244,14734,561,317
302,44,76,305.0,40.0,256,16186,1001,745
309,39,76,305.0,40.0,258,14388,1001,743
303,38,76,305.0,40.0,251,14021,445,194
305,38,76,305.0,40.0,253,14023,433,180
304,37,76,305.0,40.0,251,13661,427,176
304,43,76,305.0,40.0,257,15827,467,210
304,43,76,305.0,40.0,257,15827,564,307
308,37,76,305.0,40.0,255,13665,528,273
300,36,76,305.0,40.0,246,13296,430,184
306,38,76,305.0,40.0,254,14024,419,165
313,40,77,312.5,40.0,263,14753,587,324
313,44,77,312.5,40.0,267,16197,554,287
310,36,77,312.5,40.0,256,13306,439,183
311,42,77,312.5,40.0,263,15473,533,270
312,41,77,312.5,40.0,263,15113,568,305
313,35,77,312.5,40.0,258,12948,568,310
311,42,77,312.5,40.0,263,15473,549,286
311,35,77,312.5,40.0,256,12946,435,179
310,42,77,312.5,40.0,262,15472,561,299
311,36,77,312.5,40.0,257,13307,447,190
